BOTHWELL CASTLE	0	false
Camilty Hill	enclosure	Harburn	0	false
Thom's Water Cuts	 aqueduct (drain)	 Scalpsie to Loch Quien	0	false
Camilty Hill	Roman fortlet	Castle Greg	0	false
Auchencrow Mains	enclosure and ditches 1000m SSE of	0	false
Mutiny Stones	long cairn 1100m NNW of Byrecleugh	0	false
Ravensneuk Castle	0	false
Sliabh nan Dearc	enclosure 570m E of Cnoc Moine Raibeirt	0	false
Falla Luggie Tower	towerhouse	0	false
Bastleridge	barrow 1250m E of	0	false
Byrecleugh	 farmstead 1900m WNW of	0	false
Habchester	fort 1100m ESE of Bastleridge	0	false
Castle Hill	 fort	0	false
Castle Semple Loch	 tower house to S of loch	0	false
Walls Hill	fort	0	false
Gilbertfield Castle	0	false
Temple	 Old Parish Church	0	false
Thom's Water Cuts	 aqueduct (drain)	 Ardscalpsie to SW of Scalpsie	0	false
Oldcastles	 fort 350m NNW of	0	false
Haylie House	 chambered cairn	0	false
Larabank Castle	motte	0	false
Thom's Water Cuts	 aqueduct (drain)	 N of Drumreoch to Reservoir Wood	0	false
Arthur's Cross	cross shaft	Springhill Road	Arthurlie	0	false
Greenlees Cottages	motte SE of	0	false
Wrunklaw	fort 700m ESE of Horseupcleugh	0	false
Soutra Aisle	 burial aisle and part of site of medieval hospital	0	false
Harperrig	 cairn	 West Cairn Hill	0	false
Soutra Aisle	 part of site of medieval hospital	0	false
Glenreasdell Mains	 chambered cairn 200m SE of	0	false
Brunston Castle	0	false
Barr Castle	0	false
Tollis Hill	fort	0	false
Orbiston House	 tower house	0	false
Cnoc na Sgratha	cairn 550m N of Glenbuie	0	false
Tollishill	enclosure 50m NW of	0	false
Hilltops	 settlement 530m N of	0	false
Bothwellhaugh	Roman bath house	0	false
Moor Side	 homestead 350m WNW of	0	false
Skipness Castle and Kilbrannan Chapel	0	false
Bothwellhaugh	Roman fort	0	false
Byrecleugh	 farmstead and cultivation remains 300m SSW of	0	false
The Gowk Stane	730m ENE of Auchencorth	0	false
Andrew's Wood	settlement 380m NE of	0	false
Port Charlotte	 chambered cairn	 65m ESE of Port Mhor Centre	 Islay	0	false
The Howe	settlement 100m NNE of	0	false
Tollishill	homestead 550m SW of	0	false
Lamberton old church	 church and churchyard 75m NNE of Border View	0	false
Glengarnock Castle	0	false
Preston Market Cross	 35m ESE of 1 Preston Cottages	0	false
Tollishill Dod	homestead 250m SSW of	0	false
Rathburne House	 tower house 180m NNW of	0	false
Dun Skeig	duns & fort	0	false
Preston Church	 church and burial ground	0	false
St Mary's Chapel	chapel 250m ENE of Mount Lothian	0	false
Dodcleugh	homestead and enclosure 300m E of	0	false
Cultoon	stone circle 500m SW of	0	false
Dere Street	Roman road	Soutra to Channelkirk (part)	0	false
Crosswood	 cairn 750m SE of	0	false
Dunside Hill	 cairn 1225m S of Byrecleugh	0	false
Busby Upper Mill	 cotton mill 60m N of 1 Cartview Court	0	false
Cilleach Mhicheil	chapel 1500m SSW of	Port Charlotte	0	false
Hamilton Low Parks	 motte	0	false
No 9 Kirkbanny	 settlement 360m W of	0	false
Slochd Measach	Giant's Grave	chambered cairn	Nereabolls	0	false
Dodcleugh	fort and settlement 650m S of	0	false
Blanerne Castle	0	false
Longformacus House	enclosed cremation cemetery 1450m SW of	0	false
Laigh Mains	 castle earthworks 125m North of Mains Castle	0	false
Long Calderwood	 cairn 40m SSW of 1 Cadell Gardens	0	false
Ballinakill House	cross by entrance to drive	0	false
Clachan Churchyard	 Cross	 Cross Slabs & Tombstones	0	false
Kilcavan chapel and enclosure 265m E of Kelsay	0	false
Duncarnock	 fort	0	false
Laggan	burial ground 1000m NE of	0	false
Dirrington	farmstead 400m N of	0	false
Mordington	 medieval village and church 210m S of Mordington House	0	false
Dun nan Gall	fort	Islay	0	false
Foulden Old Tithe Barn	0	false
Blackpark Plantation	stone circle S of Kingarth	0	false
Netherton Cross	 cross	 Hamilton Old Parish Kirk	0	false
Dun Ronachain	dun 400m NE of Ronachan House	0	false
Castle Hill	motte	0	false
Dirrington	farmstead	0	false
Cnoc Ebric	fort	0	false
Glenburnie	fort 600m S of	0	false
Cladh Cill Iain	 chapel & burial ground 270m NE of Nerabus Farm	 Islay	0	false
Hillhouse	 fort 250m NNW of	0	false
Rough Hill	 motte	0	false
Kingarth	standing stones	0	false
Wilsontown Ironworks	0	false
Cuff Hill Plantation	 long cairn	0	false
Longcroft Hill	homestead 480m ESE of	0	false
Hog Hill	settlement 250m SW of	0	false
Nereabolls Northern Churchyard	 Islay	0	false
Dirrington Great Law	three cairns	0	false
Nereabolls	 chapel and burial ground 270m SW of Tigh-na-Cross	 Islay	0	false
Fairlie Castle	0	false
Ronachan Bay	fort S of	0	false
Loch Ciaran	 standing stone 1430m SW of Achaglass	0	false
Tashieburn	 horse engine platform 50m NE of	0	false
Nether Brotherstone	fort	Heriot	0	false
Oxton	Roman camps	0	false
Duns Law	fort and Covenanters' Camp	0	false
Haywood	 deserted mining village	0	false
Old Deepsykehead	long cairn 910m NE of	0	false
Carn na Faire	cairn	Gigha	0	false
Soonhope	homestead 500m NNE of	0	false
Oxton	 Roman fortlet and annexes 230m NNE of Braefoot Cottage	0	false
Over Hartside	enclosure 300m N of	0	false
Longcroft	fort 500m NE of	0	false
Kirktonhill	fort 400m WSW of	0	false
Middleton	 hut circle and enclosure 540m WSW of	0	false
Cock Rig to Linton Muir	Roman road	0	false
Dun an Rudha Buidhe	dun	Islay	0	false
Corriechrevie	cairn	0	false
Cleugh House	 bell pits and inclined plane 130m SSW of	0	false
Witches Cleuch	 fort 430m ENE of Chesterfield	0	false
Fairhill	 cairn 20m N of 96 Millgate Road	0	false
Hen Law	cairn 1550m WNW of Langtonlees	0	false
Southannan Mansionhouse	Fairlie	0	false
Upper Whitfield	enclosures 375m SE and 350m ESE of	0	false
Carn Ban	cairn Gigha	0	false
Kingavin	deserted village 650m ENE of Dunagoil	0	false
Cadzow Castle	0	false
Cairnbank	 settlement 210m ENE of	0	false
Old Deepsykehead	enclosed cremation cemetery 270m SSE of	0	false
Addinston	fort 500m NNE of	0	false
Hamilton High Parks	 park pale	0	false
Gleann a Gaoidh	chapel 460m SE of	0	false
Deils Wood	 cairn 350m E of Bonnyton	0	false
Raecleugh Head Hill	 fort 690m NNW of Raecleugh Head	0	false
St Blane's church	monastery and 'the cauldron'	Bute	0	false
Hamilton High Parks	 earthwork 475m NE of High Parks Farm	0	false
Regional War Room	 130m NW of Rankine Avenue	 East Kilbride	0	false
Hartside	 scooped homesteads 330m SSE of	0	false
Moyne	 cairn 930m E of	0	false
Dunagoil	burial chamber	forts	caves	cupmarked stone and longhouses	0	false
Raecleugh Head	fort 275m NW of	0	false
Dirrington Little Law	cairn on summit of	0	false
Bannerbank	 hut circle 965m WNW of	0	false
Talatoll	 shielings 1400m SE of	 Kintyre	0	false
Raecleugh Head	fort 150m W of	0	false
Cill a'Chuibein	 chapel	0	false
Lylestone	settlement 1200m NE of	0	false
Dun Thrudernish	fort	Trudernish Point	Islay	0	false
Evelaw Tower	0	false
Castle Hill	earthwork SSE of Glenside	0	false
Borrowston Rig	linear earthwork and hut circles	0	false
Ballochroy	three standing stones & cist 400m NE of	0	false
Evelaw	farmstead and cultivation remains 650m WSW of	0	false
Borrowston Rig	stone circles and cairns	0	false
Carragh an Tarbert	standing stone 550m NNE of Tarbert	Gigha	0	false
Overhowden	henge	0	false
Roughsware	enclosure 500m S of	0	false
Moorfoot Chapel	monastic grange and chapel	0	false
Dunsmill Farm	 settlement 125m NNE of	0	false
An Dunan	 dun 70m SW of Minen	0	false
Bents Quarry	 lime kilns and quarry	0	false
Bedshiel	cairn 950m NNE of	0	false
Dun Fhinn	 dun	0	false
Corsehope Rings	fort	0	false
Middlehill	fort	0	false
Halltree Rings	 settlement	 Chapel Hill	0	false
Woodend	 palisaded enclosure 335m NNE of	0	false
Burncastle	fort 400m NNE of	0	false
Dun Fhinn	hut circles 410m SE of	Islay	0	false
Orsay Island	chapel	0	false
Ridh a'Chaibeil	burial ground & cross SE of Tarbert	0	false
Cairnvickuie	cross incised stone NW of	0	false
Little Cumbrae	lighthouse tower & associated buildings	0	false
Hodge Cairn	fort	Shank Wood	0	false
North Kirktonmoor	cairn 330m SW of	0	false
Little Cumbrae Castle	0	false
Polnoon Castle	0	false
Dabshead Hill	fort and standing stone	0	false
Slipperfield Mount	cairn S of	0	false
Hirendean Castle	0	false
Laggan	saltpans & coal pits NW of	0	false
North Muir	cairns	0	false
Bowerhouse	fort 480m NW of	0	false
Dun an Trinnse	 dun 325m NW of Ardailly	 Gigha	0	false
North Muir	Upper Cairn	0	false
Aitnock	dun	Hindog Glen	0	false
Castle Knowe	motte	0	false
Kildalton Church	 church	 High Cross	 and cross 60m NE of	0	false
Wester Yardhouses	 souterrain 180m WNW of	0	false
East Revoch	 cairn 420m N of and cup-marked stone 485m N of	0	false
Hilton Church	 church and burial ground	0	false
Dunan an t-Seasgain	 dun 465m WNW of Drumyeonmore Farm	 Gigha	0	false
Lochranza Castle	Arran	0	false
Brewshott	 limestone quarry	0	false
Blackchester	fort	0	false
North Muir	Nether Cairn	0	false
Wester Yardhouses	 hut-circles and cairns 270m SSW of	0	false
Cortleferry	 scooped settlement 400m NW of	0	false
Torr an t'Sean Chaisteil	fort	Lochranza	0	false
Wester Yardhouses	 hut-circle 470m SSE of	0	false
Darngaber Castle	 570m ENE of Crookedstone	0	false
Dun Chibhich	 fort 400m NW of Druimyeonbeg	 Gigha	0	false
Hare Faulds	 fort 2000m NNW of Dod Mill	0	false
Crooked Stone	 standing stone 225m N of Crookedstone	0	false
Wester Yardhouses	 cairn 630m S of	0	false
Halliburton	cairn 1300m N of	0	false
Hare Law	 cairn 730m SSE of Wester Yardhouses	0	false
Hardgatehead	Roman road and turnpike road 600m SW of	0	false
Bushglen Mount	ENE of Bushglen	0	false
Bellshiel	 fort 540m N of	0	false
Craigiehall	 hut-circle 630m ESE of	0	false
Dunan Buidhe	dun	Gigha	0	false
Horndean Church	 church and burial ground	0	false
Burngrange	long cairn 800m N of	0	false
Jeffries Corse	cairn	0	false
South Slipperfield	barrows 1850m SSW and 1620m S of	0	false
Greens Moor	long cairn	cairns and field system NW of Kersewell Mains	0	false
Harelaw Moor	farmstead 1500m NE of Barebreeks Wood	0	false
Blythe	 fort 300m SW of	0	false
Northshield Rings	fort	The Camps	0	false
Ardilistry	stone setting 200m NE of	0	false
Auld Hill	fort	Portencross	0	false
Dundreich	cairn	0	false
Waulkmill	 cairn 310m SE of	0	false
Dunsyre Hill	field systems	0	false
Dunwan Hill	 fort	0	false
Dunsyre Hill	cairn	0	false
Portencross Castle	0	false
Calla	broch 650m S of	0	false
Kersewell Mains	cairn 1400m ENE of	0	false
Calla Doone	 hut-circle 500m ESE of	0	false
Trabrown	settlement 600m SW of	0	false
Laggantuin	deserted settlement	0	false
Kersewell Mains	 cairn 450m NE of	0	false
Windygates	 hut-circle 385m NNW of	0	false
Blythe	 settlement 1150m SSW of	0	false
Thirlestane Hill	fort	0	false
Herrits Dyke	linear earthwork 2400m N of Greenlaw	Greenlaw Moor	0	false
Kersewell Mains	cairn 1400m E of	0	false
Wether Law	cairn	0	false
Harelaw Moor	earthwork 750m ENE of Barebreeks Wood	0	false
Blackshaw Quarry	cup & ring marked rock 320m S of	0	false
Ardlamey	cairn 800m SW of	0	false
Symington Hillhead	fort 350m S of	Fountainhall	0	false
Couthally Castle	Carnwath	0	false
Cnoc na Carraigh	inscribed stone NE of	0	false
Thirlstane	fort 350m NE of	0	false
Achamore House	old parish church 230m N of	0	false
Whaup Law	 cairn	0	false
Romanno Mains	 two barrows 550m SE of	0	false
Blackcastle Rings	fort	0	false
Romanno Mains	 barrow 910m SE of	0	false
Houndslow	settlement 600m NW of	0	false
Greenaton Farm	 enclosed settlement 250m WNW of	0	false
Chesters	 fort	0	false
Thirlestane Castle	 old castle 510m SSW of Thirlestane	0	false
Torr an t'Sean Chaisteil	fort	Sannox	0	false
Tobar an-t Sagairt	chapel	Tockmal	0	false
Knock Jargon	cairn & fort	0	false
Eastfield	 barrow 650m NW of	0	false
Hallbar Tower	 barmkin	0	false
Courhope	 ring enclosures 750m NE of Greenside	0	false
Collielaw Wood	 Roman road SSE of Collielaw	0	false
Terrace Wood	cultivation terraces	0	false
Robertland Castle	0	false
An Dunan	fort	Islay	0	false
Nether Shiels	 enclosure 350m NW of	0	false
Auchenglen	 cairn 450m SSE of	0	false
North Glensannox	deserted settlement 900m W of North Sannox	0	false
Blyth	cairn 1050m NNW of	0	false
Romanno Hope	barrow & enclosures S of	0	false
Carnwath Golf Course	motte	0	false
North Sannox	 cairn 420m E of	0	false
Newlands Church and graveyard	 50m SW of Newlands House	0	false
Drum Maw	settlement 780m SE of	0	false
Cill Bhride	 chapel 270m SSE of Kilbride	0	false
Ballynaughton More	chambered cairn 150m SE of Carn Nic Raonuill	0	false
Craignethan Castle	0	false
Green Knowe	two ring enclosures & barrow 550m SSE of	0	false
Bordland Rings	fort	Bordlands Hill	0	false
Lauder Barns	palisaded enclosure 550m SSW of	0	false
Newmill	enclosures SW of	0	false
Whiteside Hill	fort & enclosure	0	false
Cathpair	hut circles and field system 2500m and 2600m ESE of	0	false
Ladykirk House	barrow 470m NE of	0	false
An Cnap	vitrified fort 250m N of Woodside Cottage	0	false
Watherston	fort	0	false
Wormiston	cairn 360m NNW of	0	false
Henderland Hill	fort	0	false
Milkieston Rings	fort	0	false
Ewes Hill	settlement	0	false
Newbigging market cross	0	false
Camp Wood	 Roman camp 335m SW of Campwood Farm	0	false
Ladykirk House	 barrow 105m N of	0	false
Cill Tobar Lasrach	chapel 400m NNW of Farkin Cottage	0	false
Whiteside Hill	ring enclosures 820m SE of	0	false
Whitewellbrae Wood	 henge 60m E of NE corner	0	false
Blyth Hill	fort	0	false
Flemington	ring enclosures 840m NE of	0	false
Craigend	fort 360m W of	0	false
Cot Castle	motte	0	false
Shaw Hill	cairn	0	false
Nether Stewarton	 settlement 850m W of	0	false
Clonbeith Castle	0	false
Cavarra Hill	settlement	0	false
Dunivaig Castle	0	false
Kilnaughton	 chapel	 carved stones & burial ground 135m N of Samhchair	0	false
Cragabus	 chambered cairn 75m SW of Lower Cragabus	 Islay	0	false
Eastmore	 barrow 390m NNE of	0	false
Sunadale	dun 275m NE of	0	false
Corbiehall Farm	 enclosure 570m NNE of	0	false
Castle Qua	fort 345m WSW of Mouse Bridge	0	false
Harehope	palisaded settlement 730m NNE of	0	false
Boydston Braes	motte	0	false
Callands House	earthwork S of	0	false
Woolandslee Tower	0	false
Sannox	chambered cairn	0	false
Hamilton House	 fort 275m SSW of	0	false
Killean	fort NE of	0	false
Law Mount	motte & bailey 250m SW of High Castleton	0	false
West Mains	enclosure 200m NE of	0	false
Castledykes	 Roman camps to W	 N & E of Roman fort	0	false
Harehope	earthwork 550m NNE of	0	false
Drochil Castle	fort & enclosure 1190m NNW of	0	false
Harehope Rings	fort	Harehope Hill	0	false
St John's Church	 church	 burial ground and carved stones	 Killean	0	false
St Mary's Church	 Stow	0	false
Whitslaid Tower	0	false
Avondale Castle	0	false
Tweediehall	mound 410m NNE of	0	false
Stow	old bridge	0	false
Old Harestanes	stone circle 180m NE of	0	false
Carstairs Mains	 Roman temporary camp 750m SE of	0	false
East Gordon	cairns 900m WNW of	0	false
Mersington House	 deserted medieval village 100m SW of	0	false
Castledykes	Roman fort	Corbiehall	0	false
Knock Hill	fort	0	false
Montfode Castle	0	false
Kirkurd	church SE of Castlecraig	0	false
Blackhill	barrow 80m W of	 Crossford	0	false
Green Knowe	cairn NE of	0	false
Harehope	earthwork SW of	0	false
Corsbie Tower	0	false
Littlehaugh Shiel	 fort 400m WSW of	0	false
Texa	chapel & burial ground	0	false
Our Lady's Chapel	chapel 350m N of Torsonce	0	false
Montfode Burn	motte	0	false
Lurabus	township and farmsteads	Mull of Oa	Islay	0	false
White Meldon	platform settlement 730m NNW of	0	false
Belchester	fort 200m W of	0	false
Black Hill	fort & cairn	0	false
Harehope	cairn 1510m ESE of	0	false
Drochil Castle	0	false
Lurabus House	 dun 370m ENE of	 Islay	0	false
Grogport Old Manse	dun 180m ENE of	0	false
Hillside Knowe	settlement	Glentress	0	false
Bryland	fort 640m SE of	0	false
White Meldon	platform settlement 640m NW of	0	false
Cill Eathain	chapel 370m NE of Lower Killeyan	0	false
Beacharr	standing stone & long cairn	0	false
Green Knowe	platform settlement	0	false
Castle Hill	site of Lanark Castle	0	false
Shieldgreen Tower	0	false
Kilwinning Abbey	0	false
St Kentigern's Church	 Lanark	0	false
Glentress Tower	ENE of Glentress	0	false
Upper Kidston	fort & settlement NNW of	0	false
Dun Beachaire	dun	0	false
Kilwinning	waggonway & bridge	SE of Saugh Trees	0	false
Red Cove	 dun 215m N of Beachmenach	0	false
White Meldon	enclosures W of	0	false
Kerelaw Castle	0	false
Greenknowe Tower	 Gordon	0	false
Cairn and hill fort	 White Meldon	0	false
Black Meldon	settlement and scooped homestead 550m E of	0	false
Black Meldon	fort	0	false
New Lanark	 Mill Number Four	0	false
Beachmeanach	 enclosure 700m ESE of	0	false
Hamildean	homestead 1140m NE of	0	false
Lochurd Hills	 enclosures 485m and 435m W of and 245m and 465m WSW of Woolshears Hill	0	false
Ardrossan	castle	0	false
Crosshall	cross	0	false
High House of Edmonston	tower house	0	false
Wester Happrew	fort 360m NW of	0	false
Glenbield	 fort 800m ENE of	0	false
Brownsbank	enclosure 300m SE of Stirkfield Farm	0	false
Hamildean Hill	fort	0	false
Burnbrae	barrow 170m NW of	0	false
North Beachmore	 rock art panels 220m E	 350m E and 385m ESE of	0	false
South Hill Head	settlement WNW of	0	false
Ardeer Recreation Club	subterranean passage & cave	0	false
Carragh an Talaidh	chambered cairn	Brackley	0	false
Hyndford House	crannog 135m NNW of	0	false
The Mount	 motte-and-bailey castle	0	false
Green Hill	 settlement	0	false
Bow Castle	broch 1000m E of Bow	0	false
Hillhead	earthwork 1220m NNW of	0	false
Venlaw Castle Hotel	settlement 780m NE of	0	false
Lochurd Farm	ring enclosures & mound 1550m S of	0	false
South Hill Head	homestead	0	false
Hirsel Law	 fort	0	false
Hillhead	earthwork 930m N of homestead moat	0	false
Corra Castle	0	false
Hume Castle	 castle and associated settlement	0	false
Eccles	 St Mary's Convent	 nunnery	0	false
Muirburn Castle	fort & scooped settlement	0	false
Castle Hill	fort 550m WSW of Candybank	0	false
Cill Chomhan	 chapel and burial ground 480m NE of Stremnishmore	 Islay	0	false
Pyked Stane	cairn	Pyked Stane Hill	0	false
Lyne	 Roman temporary camp	0	false
Tor Hill	fort 600m WNW of Torbank	0	false
Dun Domhnuill	 dun 70m NNE of Seafield	0	false
Lawthorn Mount	mound	0	false
Crosskirk	 church and friary	 Peebles	0	false
Craighead Mill	Lesmahagow	0	false
Dun Athad	 fort	 Islay	0	false
Peebles	town wall	0	false
Ewe Hill	barrows 750m NE of Biggarshiels Farm	0	false
Peebles	St Andrew's Church	0	false
Lyne	Roman fort	annexes and fortlet	0	false
The Hirsel	settlements & ecclesiastical remains S of	0	false
Blackhouse Burn	enclosures	0	false
Stirkfield Rig	ring enclosures	0	false
Stirkfield	settlements and cultivation remains 1300m ESE of	0	false
Meldon Bridge	pit alignment 250m W of	0	false
Janet's Brae	 fort 750m E of Peebles Hydropathic	0	false
Janet's Brae	 fort 550m E of Peebles Hydropathic	0	false
Meadowflatt	enclosure 900m NW of	0	false
Stirkfield	barrow and enclosed cremation cemetery 1120m ESE of	0	false
Clashpock Rig	homestead	0	false
Low Clachaig	cup marked boulders 915m E of	0	false
Dunan Muasdale	dun	0	false
Sheriff Muir	 cairn	0	false
Easter Happrew	Roman fort	0	false
Hareheugh Craigs	 fort and settlement	0	false
Horsburgh Castle Farm	 settlement 930m NNW of	 Castle Hill	0	false
Sheriff Muir Cottages	standing stones 520m W of	0	false
Homebank	enclosure 1100m ENE of	0	false
Covington	castle & dovecot	0	false
Windydoors Farm	 Bastle	0	false
Langshaw Tower and associated structures	0	false
Nether Horsburgh	castle	0	false
Lee Tower	0	false
Sweethope Hill	fort and settlement	0	false
Homebank	ring-ditch 1500m E of	0	false
Penveny	settlement & scooped homestead NW of	0	false
Colmslie Tower	0	false
Broughtonknowe	 ring enclosures & barrow 420m NE of	0	false
Easter Toftcombs	fort 820m NW of	0	false
Chester Hill	fort	0	false
Eshiels	 Roman camps 90m SSW of No 4 Eshiels	0	false
Glentress	St Leonard's Hospital	0	false
Bizzyberry Hill	fort & Wallace's Well	0	false
The Common	 settlement 400m SE of	0	false
Huskie Rig	mounds	0	false
Broughtonknowe	three barrows 230m SE of	0	false
Nether Horsburgh	enclosure 620m SE of	0	false
Cottage Hospital	 settlement 250m SW of	0	false
Horsburgh Castle	0	false
Seagate Castle	0	false
Carragh Muasdale	standing stone 225m N of South Muasdale	0	false
Broughton Knowe	ring enclosures	0	false
Hogbridge	palisaded enclosure 55m E of	0	false
Cardrona Mains	standing stone 180m W of	0	false
Tor Hill	fort	0	false
Lochton	enclosure 250m SSE of	0	false
Hammer Knowe	fort & settlement	0	false
Dun Ach'na h-Atha	dun	0	false
Cairn Hill	 cairn	 Walkerburn	0	false
Garvalt	 dun 500m SW of	0	false
Birgham Haugh	fort and enclosures 800m SW of	0	false
Dougarie Lodge	hut circles 800m NE of	0	false
Kerr's Knowe	 fort	0	false
Torwoodlee	 broch	 fort & linear earthworks	0	false
Quothquan Law	 fort	0	false
Langlaw Hill	fort	enclosure & barrows	0	false
Airds Castle	 235m SE of Barncluith	 Carradale	0	false
Bellanrig	settlement SE of	0	false
Whitehaugh	fort 1010m SE of	0	false
Walkerburn	 cairn 500m S of summit of Cairn Hill	0	false
Syke Hill	fort	0	false
Bellanrig	settlement	fort & enclosures 870m SE of	0	false
Skirling Mains	enclosure 320m WSW of	0	false
Buckholm Tower	0	false
Cardrona Tower	0	false
Burghmuir Farm	enclosures 550m S of	0	false
Portrigh Strip	earthwork	0	false
Old Caberston	 scooped settlement 310m E of	0	false
Torwoodlee Tower	0	false
Gillespie Moat	motte	Parkmanse Garden	0	false
Kirkton Manor	enclosures 550m SE of	0	false
Blary	dun ENE of	0	false
Redden	fort and enclosure 750m E of	0	false
Whytbank Tower	 ancillary buildings and garden	0	false
The Kirna	settlement 270m NW of	0	false
Glenacardoch	 dun 730m WNW of	0	false
Heavyside	two enclosures 1000m E of	0	false
Cademuir Hill	fort 1200m W of	0	false
Nenthorn	deserted village	farmsteads	mill and field system	0	false
Estate Office	standing stones 500m NE of	0	false
Purvishill Tower	 cultivation terraces	 enclosure and tower	0	false
Redden	 settlement 60m SE of	0	false
Piper's Grave	cists	0	false
Woodhouse Hill	fort	0	false
Easter Dawyck	fort & settlement 730m ESE of	0	false
Castle Knowe	 fort	0	false
Pirn Wood	fort	0	false
Charge Law Plantation	fort & settlement	0	false
Haystoun	fort 1190m S of	0	false
Old Redhead	 deserted settlement 15m NE of and 25m ESE of	0	false
Cademuir Hill	fort 1800m WSW of	0	false
Barlea	standing stone & cairn	0	false
Auchencar	hut circle 450m NNE of	0	false
Black Hill	 fort	0	false
Boghall Castle	Biggar	0	false
Ratchill	platform settlement 550m N of	0	false
Cauld Face	cultivation terraces	0	false
Broughton Church	0	false
Upper Newby	fort 320m SSE of	0	false
Caerlee Hill	 fort	0	false
Thankerton	fort 1500m SW of	0	false
Auchencar	hut circle and field system 700m NE of	0	false
Hog's Knowe	settlement 400m WNW of Glenternie House	0	false
An Dunan	dun	WSW of Auchadaduie	0	false
Ratchill	platform settlement and ring enclosure 460m NE of	0	false
Boghall	earthwork 460m S of	0	false
Park Knowe	enclosure 1500m SSW of Thankerton	0	false
Carradale	fort	Kilbrannan Sound	0	false
West Bold	earthworks & enclosures 400m SSW of	0	false
Stronach Wood	 prehistoric rock carvings 700m WSW of Brodick School	0	false
Elibank Castle	0	false
Standing stones	 170m NW of Druid Barn	0	false
Coulter Motte	motte	Wolfclyde	0	false
Plora Craig	tower & associated structures NE of	0	false
Cademuir	 earthwork 360m SE of	0	false
Whitmuirhaugh	settlement & cemetery	0	false
Upper Newby	fort 910m SSE of	0	false
St John's Kirk	fort 360m WNW of	0	false
Chester Hill	fort & settlement	0	false
Richard's Knowe Strip	settlement 150m WNW of St John's Kirk	0	false
Brotherstone Hill West	 fort	0	false
Bamflatt	settlement 870m SSW of	0	false
Brotherstone	enclosure 500m NE of	0	false
Cnoc a'Chlochair	fort and field system	0	false
Cornhill	Roman camp N of	0	false
Lour	fort & settlement	0	false
East Mayish	standing stone 100m ESE of	0	false
Caddonlee	fort	0	false
Dreva Craig	 fort	 settlements & field system	0	false
Kilbucho House	cairn 1010m NW of	0	false
Castlehill	tower	0	false
Drumelzier Haugh	standing stone 640m WNW of	0	false
Dungavel Hill	cairn	0	false
Castlehill	 fort 250m WSW of	0	false
Helm End	 fort and settlement	0	false
Kilbucho Mains	 settlement 750m WSW of	0	false
Moinechoill	long cairn	Glean an t'Suidhe	0	false
Blacksyke	 engine house	0	false
Grieston Hill	fort	0	false
Chester Hill	fort	0	false
Easter Hill	fort	0	false
Machrie Farm	hut circles 1600m NNE of	0	false
Kilbucho House	settlement 360m WNW of	0	false
Crois Mhic Aoidh	 standing stone	0	false
Machrie Farm	stone setting 1450m NE of	0	false
Canada Hill	scooped homestead WSW of	0	false
Young Bush Wood	enclosure NW of	0	false
Dun Sheallaidh	dun	0	false
Glenrath	 settlement & fort 1190m NW of	0	false
Smailholm Tower	 tower	 buildings and enclosures	0	false
Ring Knowe	fort	0	false
Auchengallon	cairn 150m WSW of	0	false
Sandyknowe	earthwork SW of	0	false
Threepland Hill	cairn	0	false
Glenrath	settlement 1010m NE of	0	false
Machrie Farm	standing stone 1100m NE of	0	false
Hollybush	earthwork	0	false
Machrie Farm	hut circles 1050m and 1200m NE of	0	false
Dundonald Castle	0	false
Castle Hill	earthwork	Symington	0	false
Tinnis Castle & fort	0	false
Tinto Cairn	cairn on summit of Tinto Hill	0	false
Orchard Rig	settlements	enclosures	cairn and field system	0	false
Glenrath	settlement 730m NE of	0	false
Melrose Abbey	0	false
Mitchelhill Rings	 fort	0	false
Henry's Brae	fort	0	false
Castle Hill	earthwork 820m SW of	0	false
Old Melrose	 St Cuthbert's Chapel & monastery site	0	false
Mitchelhill	 palisaded enclosure and cairn 200m NW of	0	false
Old Melrose	linear earthwork 300m W of	0	false
Rudha nan Sgarbh	dun	0	false
Old Roxburgh	deserted town between River Teviot & River Tweed	0	false
Shaw Hill	cultivation terraces 450m NE of Coulter Shaw	0	false
Newstead Roman military complex	 660m WSW of Broomhill Farm	0	false
Glenrath	settlement 550m ENE of	0	false
White Hill	 fort	0	false
Dun Fionn	fort & cultivation terraces 600m NNE of Clauchlands	0	false
Kilbucho Church	0	false
Trebetha Hill	 cairn 140m NNW of Mill Rings Settlement	0	false
Dun a'Bhuic	dun SW of Cleongart	0	false
Roxburgh Castle	0	false
Kelso Abbey	0	false
Kemp Law	fort	0	false
Shaw Hill	ring enclosure on summit	0	false
Mill Rings	 earthwork	 Trebetha Hill	0	false
Cleongart	dun SE of	0	false
White Hill	 cairn 300m S of	0	false
Cardon	fort NW of	0	false
Machrie Farm	hut circle and cultivation remains 800m ESE of	0	false
Coulter	cultivation terraces 450m SE of	0	false
Drumelzier Castle	0	false
Blendewing	cairn 550m SE of	0	false
Drumelzier Castle	settlement 780m E of	0	false
Wood Hill	fort & enclosure	0	false
Wood Hill	settlement 230m E of	0	false
Corputechan	 hut circles E of	 Kintyre	0	false
Lamlash Road	 stone circle	0	false
Pinnaclehill Farm	burial mound & cists 90m NW of	0	false
Craig Hill	enclosure	0	false
Coulter	settlement 190m NE of Cow Castle	0	false
Knowe Kniffling	fort	0	false
Yair	fort	Oakbank Wood	0	false
Posso	tower & associated structures WNW of	0	false
Birk's Cairn	cairn	Birkscairn Hill	0	false
Dunan Mor	 chambered cairn	 Lamlash	0	false
Cow Castle	fort	0	false
Rink Hill	fort 700m NE of	0	false
Culterpark Hill	fort	0	false
Machrie Farm	cairn	hut circles and cultivation remains 800m S of	0	false
Nisbet	hut circle 640m ENE of	0	false
Dunan Beag	 chambered cairn and standing stone	0	false
Glenholm Church	0	false
Langloch Knowe	fort E of Nisbet	0	false
Snaip	 settlement 380m SSW of	0	false
Glenholm	homestead 420m ESE of	0	false
Eildon Hill North	fort & Roman signal station	0	false
Cardon	settlement 650m SW of	0	false
Wardlaw Hill	earthwork W of Harpercroft	0	false
Camp Castle	0	false
Rink Hill	fort	0	false
Snaip Hill	fort	0	false
Moss Farm	cairn 870m WNW of	0	false
Tweedford	cairn	0	false
Glenrathope	settlement 1300m WNW to 350m E of Glenrathope	0	false
Craigie	fort 250m N of	0	false
Wallace's Trench	linear earthwork	0	false
Wardlaw Hill	earthwork SSW of Harpercroft	0	false
Bellochantuy	dun	0	false
Huntly Burn	earthworks	0	false
Moss Farm	 Machrie Moor	 stone circles	 cairns	 hut-circles and fields	0	false
Kilbride Chapel	 old church and graveyard	 Lamlash	 Arran	0	false
Bridge Farm	stone settings 500m NNW and 1040m NW of	0	false
Preston Hill	earthwork SE of	0	false
Nisbet	fort 740m S of	0	false
Saddell House	fort 450m NE of	0	false
Saddell Abbey	0	false
The Rings	fort & settlement 910m SSW of Glenholm	0	false
Lamington Tower	0	false
Sunderland Hill	earthwork	0	false
Sunderland Hall	cairn 1500m W of	0	false
Bridge Farm	 hut circles and cultivation remains 350m E of	0	false
Castle Hill Strip	fort	0	false
Langhaugh	cairn 820m N of	0	false
Craigie Castle	0	false
Cauldshiels Hill	fort	0	false
Tormore	hut circle 510m ESE of Torr Righ Beag	0	false
Dryburgh Abbey	0	false
Machrie Moor	 hut circle 540m SE of Crochandoon	0	false
Dun Putechantuy	 dun	 Kintyre	0	false
Mossfennan	cairn 510m SE of	0	false
Littledean Tower	tower-house	0	false
Linglie Hill	linear earthwork	0	false
Tormore	 hut circle 450m SE of Torr Righ Beag	0	false
Ringleyhall	fort	0	false
Machrie Moor	 prehistoric settlement 650m SSE of Crochandoon	0	false
Cairn Rig	cairn	0	false
Tormore	 hut circles 450m ENE of Torr Righ Mor	0	false
Helenton Mote	motte	0	false
Tormore	 hut circles 700m and 760m E of	0	false
Tormore	 long cairn 875m SSE of Crochandoon	0	false
Glen Garr	cairn	0	false
Killocraw	fort NW of	0	false
Kirkhope	scooped homestead N of	0	false
Langhaugh	tower & associated buildings	0	false
Thorril Castle	bastle house 450m NNE of Parkhead	0	false
St Bride's Church	 Douglas	0	false
King's Cave	Torbeg	Blackwaterfoot	0	false
Langhaugh	settlement 130m SSE of	0	false
Lindean	earthwork	0	false
Caves	S of King's Cave	Isle of Arran	0	false
Lindean	old church	0	false
Killocraw	cup marked stone 800m E of	0	false
Hopecarton	 buildings 250m SSE of	0	false
Worm Hill	cairn	0	false
Kirkhope	crossbase	tower & associated structures 500m WSW of	0	false
Killocraw	 cairn 640m E of	0	false
Blake Muir	platform settlement	0	false
Dun Fhinn	dun 300m W of Killocraw	0	false
Hopecarton	 enclosure 410m SSW of	0	false
Hopecarton	 settlement 530m SE of	0	false
Dungavel Hill	cairn	0	false
Killocraw	 cairn 450m ESE of	0	false
The Bank	 settlement 485m SW of Kirkhope	0	false
Baitlaws	cairn 750m ENE of	0	false
Torr Righ Mor	hut circles and cultivation remains S of	0	false
Easter Stanhope	homestead 780m NW of	0	false
Stanhope Cottage	 burial cairn 240m NNE of	0	false
Barnweill	homestead moat	0	false
Crosbie House	 remains of	0	false
Hangingshaw	earthwork	0	false
Stanhope	 scooped settlement and enclosure NNE of	0	false
Linglie	fort	0	false
Faldonside to Kippielaw	linear earthwork	0	false
Stanhope	 settlement 160m N of	0	false
Barnweill Church	0	false
Long Philip Burn	earthwork	0	false
Patervan	fort	settlement & cultivation terraces 1050m NNW of	0	false
Stanhope	 farmsteads SSW of	0	false
Stanhope	 fort	 scooped settlement and enclosed settlements SW of	0	false
Blacksidend	cairn	0	false
Corby Linn	earthwork	0	false
Glenbuck Ironworks	 470m NW of Glenbuck Home Farm	0	false
Newark Castle	Philiphaugh	0	false
Stanhope	 enclosed settlement 800m SW of	0	false
Broadhill End	cairn	0	false
Stanhope	 unenclosed platform settlement 850m SW of	0	false
The Doon	fort and standing stones	0	false
Norman's Castle	 dun 830m SW of Stanhope	0	false
Devonshaw Hill	enclosure 300m NNE of summit	0	false
Devonshaw Hill	cairn 700m ENE of	0	false
Meallach's Grave	long cairn	Monamore Glen	0	false
Patervan	 burial cairn and buildings N of	0	false
The Bower of Wandel	 Tower.	0	false
Castle Dykes	earthwork	Roberton	0	false
Devonshaw Hill	cairn	0	false
Bell Hill	fort 910m NE of Smedheugh	0	false
Patervan	 settlement SSE of	0	false
Ugadale Point	dun	0	false
Wildshaw Hill	cairn 500m WSW of summit	0	false
Nethermuir	homestead and enclosure 250m SW of	0	false
Muirhouselaw	homestead moat	0	false
Philiphaugh	 settlement and burial ground 150m S of Calton Cottage	0	false
Devonshaw Hill	fort 500m NE of Woodend Farm	0	false
Kingscross	Viking burial mound & dun	0	false
Stanhope	 unenclosed platform settlement SE of Shaw Burn	0	false
Chester Knowes	 enclosure	0	false
Tripans Knowe	enclosure	0	false
Peel Hill	 motte and bailey castle	 Selkirk	0	false
Burnt Humbleton	fort	0	false
Stanhope	platform settlement	field system & farmstead S of Taberon Law	0	false
Tangy Loch	fortified dwelling	0	false
Hillend	enclosures 250m ENE of	0	false
Chapelhouse	chapel and farmstead	0	false
Whiteside	 settlement 120m WSW of	0	false
Philiphaugh	linear earthwork	0	false
Kildonan	dun	0	false
Warrior's Rest	standing stone	0	false
Stanhope	 buildings and enclosure W of Lairdside Knowe	0	false
Green Humbleton	fort	0	false
Glebe Stone	standing stone	0	false
Yarrow Stone	inscribed stone 250m E of Whitefield	0	false
Glenkerie Burn	fort	0	false
Port a' Chaisteil	 dun 505m SSW of Tangy Lodge	0	false
Tarbolton	motte	0	false
Skeroblin Hill	cairn	0	false
Ardnacross	 chambered cairn 1000m NNW of	0	false
Windgate House	bastle house and associated structures	0	false
Port nam Marbh	dun W of Drumalea	0	false
Auchensaugh Hill	cairn	0	false
Thirstone	stone circle 1300m NNW of	0	false
Kildonald Point	 fort and cairn 515m SE of Kildonald Cottage	0	false
Halterburn	farmstead 700m E of	0	false
Skeroblingarry	standing stone 275m N of	0	false
Stob Stones	standing stones	0	false
Old Foundry Holm	ironworks	0	false
Howden	motte	0	false
Gort na h-Ulaidhe	 long cairn 900m NE of Gartgreillan	 Glen Lussa	0	false
Halterburn	farmsteads 400m ESE of	0	false
Haughhead Kip	mound	0	false
Westport	fort 240m N of	0	false
Wandel	Roman fortlet and camp 460m SW of	0	false
Prestwick	 Old Parish Church	0	false
Castle Hill	earthwork	0	false
Peniel Heugh	 fort	0	false
Kilpatrick	dun	enclosure	hut circles	cairn and field system 1km S of	0	false
Gargadale	settlement and field system	0	false
Puball Burn	enclosure 580m SE of Skeroblingarry	0	false
Kilkeddan	 dun 850m W of	0	false
Carn Ban	chambered cairn	Arran	0	false
Brownmoor Glen	fort	0	false
Shields	enclosure 500m E of	0	false
Catrine	 water works for Catrine Mill 30m S of 9 St Cuthbert's Street	0	false
New Greenhill	fort	0	false
Ardnacross	long cairn 340m SSE of	0	false
Largiemore	fort NE of	0	false
Burnhead	scooped settlement and house 300m NE of	0	false
Old Halterburnhead	homestead 600m NE of	0	false
Highpark	standing stone	0	false
Middlestead	earthwork	0	false
Trench Knowe	dun	Glen Lussa	0	false
Kingencleugh Castle	0	false
Ballochmyle Viaduct	rock carvings 280m NE of	0	false
Muirkirk	 remains of tar works	 mines and structures E of Garpel Water	0	false
Glenveg	scooped homestead SW of	0	false
Glenlussa Lodge	standing stone	0	false
Burnhead	homestead 500m SE of	0	false
Mid Hill	earthwork	0	false
Steer Rig	palisaded settlement 820m ENE of Old Halterburnhead	0	false
Countridge Knowe	cultivation terraces	0	false
Oakwood	 Roman fort and camp SSE of	0	false
Balnagleck	 dun 350m NE of	0	false
Wildgoose Hill	 fort 610m SW of Burnhead	0	false
Glenashdale Wood	fort 1340m WNW of Giants Graves	Arran	0	false
Nether Oliver Crags	fort	0	false
Old Halterburnhead	settlements 100m SW of and 200m SE of	0	false
Cold Chapel	settlement 500m NE of	0	false
The Chester	 enclosure 180m NE of Glenrusko	0	false
Oliver Castle	fort	0	false
Aucheleffan	 stone setting 550m NW of	0	false
Kirkhope Tower	 barmkin and barmkin wall S of	0	false
Abington	motte & bailey 1600m N of	0	false
Brockhill Burn	earthwork	0	false
Ranachan Hill	fort	0	false
Castle Hill	 fort	0	false
Whiteside Rig	 fort & enclosure	0	false
Kilchenzie Church	church & tombstones	0	false
Riddell	 motte and bailey 600m NE of	0	false
Torran Loisgte	 chambered cairn 100m ENE of	 Arran	0	false
Netherton	cairn 800m SW of	0	false
Dryhope Tower	tower house and settlement	0	false
Dryhope	 hut circle	 cairns and field system 500m WNW of	0	false
Giants' Graves	 long cairns	 Whiting Bay	 Arran	0	false
Mantle Walls	 Ancrum	 bishop's palace	0	false
Ancrum	market cross	0	false
Clerklands	fort	0	false
Clochkeil	standing stones NW of	0	false
Huntly Burn	enclosure	0	false
Cairn Table	two cairns	0	false
Huntly Burn	earthwork	0	false
Craighead	 platform settlement 1200m WNW of	0	false
Craighead	 barrow and cairn 820m NW of	0	false
North Craigs	 enclosure 280m N of	0	false
Menzion Farm	 Giant's Stone	 cairn & standing stones 590m NE of	0	false
Menzion Farmhouse	 two enclosed cremation cemeteries 400m NNW of	0	false
Black Hill	fort 650m NW of Craighead	0	false
North Synton	fort	0	false
Morebattle Hill	fort	0	false
Ballywilline Hill	fort	0	false
Cessford Castle	0	false
Enterkine	barrow 550m ENE of	0	false
Arbory Hill	fort	0	false
Bealach Gaothar	ring cairn 700m NW of Largybeg	0	false
Sliddery	 chambered cairn	0	false
St Mary of the Lowes	 churchyard 1200m WSW of Kirkstead	0	false
Craigs	standing stone	0	false
Glencraigs	standing stone 300m NW of	0	false
Menzion Farm	enclosed cremation cemetery 600m WSW of	0	false
Weird Law	 platform settlement 550m S of summit	0	false
Shoulder Hill	homestead	0	false
Cliftoncote	cultivation terraces	0	false
Torr a'Chaisteal	dun	Arran	0	false
Auchinleck Castle	0	false
Auchinleck Old House	0	false
Kip Knowe	settlement	0	false
Menzion Farm	three enclosed cremation cemeteries 1550m WSW of	0	false
Glenwhappen Rig	 palisaded enclosure 1450m NE of Glenbreck	0	false
Camps Knowe Wood	fort	0	false
Ballywilline	dun 550m NE of	0	false
Fagyad Hill	cairn	0	false
Butter Sike	enclosure 900m ENE of Attonburn	0	false
Menzion Farm	 settlement 735m SSW of	0	false
Menzion Farm	cairn 1280m SW of	0	false
Kilmichael	 Old Parish Church SE of farm	0	false
Menzion Farm	palisaded settlement 1550m SW of	0	false
Low Smerby	 four cairns 420m SE of	0	false
Timpendean	tower & earthwork	0	false
Island Muller Castle	0	false
Hawkshaw Farm	 unenclosed platform settlement 1240m E of	0	false
Glenbreck	two barrows 1280m NE of	0	false
Knock Scalbart	fort NNE of Leckavroan	0	false
Glaisnock	ring-ditch 140m SE of	0	false
Sourhope	unenclosed platform settlement and field system 1900m N of	0	false
Trabboch Castle	0	false
Berries Burn	cairn 800m NNW of Castle Crawford Farm	0	false
Ayr Fort Wall (part)	 Arran Terrace	 Ayr	0	false
Elliesheugh	farmstead and field system	0	false
Normangill	henge	0	false
Ayr Fort Gate	 nos.2 and 2A Montgomerie Terrace	 Ayr	0	false
Kilchousland Church	 church and burial ground	0	false
Campshead	unenclosed platform settlement 800m WNW of	0	false
Glenbreck	cairn 680m NE of	0	false
Castle Crawford Farm	enclosure 585m NNW of	0	false
Hownam Law	fort and cairn	0	false
Ayr Fort Wall (part)	 Ailsa Place	 Ayr	0	false
Campknowe Plantation	fort & enclosure	0	false
Kirkton	fort 860m NNE of	0	false
Broadlee Hill	fort	0	false
Castle Crawford Farm	fort 500m NW of	0	false
Midlock	cairn 640m NE of	0	false
Fall Hill	enclosed cremation cemetery 650m NE of Midlock	0	false
Grange Hill	 platform settlement 1000m ENE of Glenbreck	0	false
Glencaple	platform settlement 600m NW of	0	false
Auchope	settlement 325m NW of	0	false
Ulston Moor	Roman camp 600m N of Overwells	0	false
Auchope	scooped homestead 80m NW of	0	false
Kirkton	fort 1155m ENE of	0	false
Sourhope	unenclosed platform settlement 1400m N of	0	false
Kirkton	settlement 1280m ENE of	0	false
Normangill Rig	cairn 1000m S of Normangill	0	false
Baraskomill	 fort and shielings 600m NW of	0	false
Attonburn	settlement 1300m SE of	0	false
Glencaple	burnt mound 980m WNW of	0	false
Crawford	Roman fort	0	false
Cairn Kinny	0	false
Auchope	homestead 475m WSW of	0	false
Sourhope	cairn 1150m NNW of	0	false
Crawford Castle or Lindsay Tower	0	false
Kip Knowe	fort	0	false
Lettershaws	platform settlement 1000m NE of	0	false
Normangill Rig	platform settlement E of Midlock	0	false
Baraskomill	dun 275m NNE of	0	false
Balegreggen	standing stone 595m ESE of	0	false
Bellfield	 fort and dun 250m NE of	0	false
Auchope	scooped homestead 400m SW of	0	false
Cappuck	Roman fort	0	false
Clachaig	 chambered cairn	0	false
Glenbreck	platform settlement 630m SW of	0	false
Torrylin	chambered long cairn 610m SW of	0	false
Auchope	settlement 550m SSE of	0	false
Midlock	platform settlement 1000m ESE of	0	false
Mow Law	enclosures and field system NE of Mowhaugh	0	false
Kildonan Castle	0	false
Fatlips Castle	0	false
Wester Essenside	fort	0	false
Uisaed	 cairn 330m NW of Fisherman's Cottage	0	false
Craigdhu	fort 380m S of	Arran	0	false
Jedburgh Franciscan Friary	0	false
Braemoor Knowe	 cultivation  terraces	0	false
East Bennan	long cairn	0	false
Sourhope	cultivation terraces	homestead & hut circles	0	false
Fasset Hill	palisaded settlement	0	false
Glenbreck	platform settlements 1100m SW of	0	false
Cnocan Sithean	cairn	Machrihanish	0	false
Whelphill	 unenclosed platform settlement 390m W of	0	false
Sourhope	settlements and field system 1600m ENE of	0	false
Cnoc Sabhail	dun	Machrihanish	0	false
Campbeltown Cross	Hall Street	0	false
Jedburgh Abbey	 50m ESE of Abbey House	0	false
Fasset Hill	cultivation terraces	0	false
Sourhope	scooped settlement 1050m ENE of	0	false
Hawkshaw Castle	0	false
Sourhope	scooped homesteads 200m NE and 300m ENE of	0	false
Boghead	platform settlement 500m SW of	0	false
Ashkirkshiel earthwork 1600m SE of Ashkirktown	0	false
Kilkivan	old parish church 150m W of High Kilkivan	0	false
Kaim Knowe	farmstead 850m E of Sourhope	0	false
Cnocan a'Chluig	cairn & barrow 135m SSW of Kilkivan Quarry	0	false
Bught Stack	field system	0	false
Park Law	fort	0	false
Leap Linn	earthwork	0	false
Andrew's Knowe	cairn	0	false
Swindon Cottage	farmstead 700m SE of	0	false
Leap Hill	earthwork	0	false
Calroust	cultivation terraces	0	false
Torchoillean	standing stone and cairn 850m NW of	0	false
Kilkerran Cemetery	 Cristin's Cross and MacEachern's Cross	0	false
Park Law	homestead 500m SE of	0	false
Stoneyburn	platform settlement and field system 700m WSW of	0	false
Bonnie Laws	settlement and field system 850m NE of Cocklawfoot	0	false
Bonnie Laws	cairn 700m N of Cocklawfoot	0	false
Thowliestane Hill	fort	0	false
Hownam Rings	 fort	 settlement	 stone row and linear earthwork	0	false
Highpark	enclosure 250m NW of	0	false
Knowesouth Burn	 earthwork	0	false
Greenan Castle	0	false
Kyle Castle	200m E of Dalblair	0	false
The Castles	fort	0	false
Stoneyburn	cairns 800m SW of	0	false
Scraesburgh	earthwork	0	false
Ballygroggan	 dun 175m SW of	0	false
Low Glenramskill	 dun 600m ENE of	0	false
Waterhead	platform settlement 900m N of	0	false
Craik Moor	palisaded settlement	fort and cultivation remains	0	false
Thowliestane Hill	 settlement 400m SSE of summit	0	false
Cocklawfoot	enclosure	farmstead and cultivation remains 250m NNE of	0	false
Cocklawfoot	farmstead	homestead	settlement & field systems 500m NE of	0	false
Cocklawfoot	enclosure 150m NW of	0	false
Heads of Ayr	 fort 1050m NNW of Genoch Farm	0	false
Outer Souter Cleugh	cairns	0	false
Collins Burn	enclosure 750m NW of Elvanfoot Bridge	0	false
Ballygroggan	dun 640m SSW of	0	false
Kildalloig	 fort 800m WSW of	0	false
Dere Street	Roman road	Whitton Edge to Cunzierton	0	false
Lintalee	earthworks	0	false
Dry Slack	farmstead and enclosure	0	false
Killeonan	chapel & burial ground 300m SW of	0	false
Camp Tops	fort	linear earthwork and field system	0	false
Alloway Kirk	0	false
Headshaw Law	cultivation terraces	0	false
Alloway	motte	0	false
Camp Tops	linear earthwork	0	false
Midshiels	standing stone	0	false
Blackbrough Hill	fort	0	false
Midshiels	mound	0	false
Brigend Castle	0	false
Bealloch Hill	forts	0	false
Kilchrist	dun 450m ESE of	0	false
Hayhope Knowe	palisaded settlement	settlement & field systems	0	false
Fundhope Rig	homestead	linear earthwork and field system	0	false
Kelsocleugh	settlement 400m SSW of	0	false
North Shortcleugh	platform settlement 1500m E of	0	false
North Shortcleuch	platform settlement 1000m E of	0	false
Cunzierton	fort	0	false
Upper Chatto	 deserted village and moated homestead	0	false
Martnaham Castle	0	false
Elm Knowe	settlement	0	false
Tushielaw Tower	0	false
Cullan Doon	fort & dun 450m ENE of Uigle	0	false
St Ciaran's Cave	Achinhoan Headland	0	false
Kelsocleugh	 farmstead 950m S of	0	false
Sundhope Kipp	 fort	 homestead	 settlement and field system	0	false
Little Rough Law	fort 700m ESE of The Yett	0	false
Bodsberry Hill	fort	0	false
Pisgah Saucer Barrows or Whitefield Cairns	0	false
Lindston	moat	0	false
Glengeith	 settlement	 bastle house and field system	0	false
Outer Cock Law	 old roads and linear earthwork	0	false
Auchencloigh Castle	0	false
Chatto Craig	fort	0	false
Wallace's Stone	cross-incised stone	0	false
Kemp's Castle	settlements & field system & settlement 600m WSW of	0	false
Fall Kneesend	 enclosed cremation cemetery	0	false
Bodsberry Hill to Little Clyde	Roman road	0	false
Dunduff	fort 600 m NE of	0	false
Historic gold workings	 Leadhills	 South Lanarkshire	0	false
Lochorodale	 long cairn 1000m NW of	0	false
Swanlaws	 farmstead 250m NNE of	0	false
Craigmuir Mote	dun	0	false
Trestle Cairn	cairn	0	false
Lochorodale	 cup-marked rock 1100m WNW of	0	false
Little Clyde	Roman camp	0	false
The Law	fort	0	false
Dunure Castle and dovecot	0	false
Fulton Tower	0	false
Hut Knowe	settlements & field systems	0	false
Shank End	 scooped settlement	0	false
Drouk Knowes	homestead and field system	0	false
Rubers Law	fort & Roman signal station	0	false
Air Cleuch	cairns 1300m S of Glengeith	0	false
Windy Gyle	cairns 480m & 700m NE of summit of	0	false
Balnabraid Glen	cairn 50m W of Corphin Bridge	0	false
Achnaclach	 fort 680m NW of	0	false
Crooked Stone	 standing stone 160m N of Crookedstane	0	false
Nap Hill	 Roman signal station 900m SE of Little Clyde	0	false
Pennymuir Bridge	 barrow cemetery 700m NE of	0	false
Lochorodale	long cairn 505m SW of	0	false
Russell's Cairn	 cairn	0	false
Crookedstane	platform settlement 200m E of	0	false
Crookedstane	platform settlement 1300m W of	0	false
Killellan	 dun 325m E of Killellan Lodge	0	false
Huntfold Hill	 fort and field system	0	false
Killellan House	chapel	0	false
Black Rig	 linear earthwork N of Kingside Loch	0	false
Giant's Grave	 earthwork	0	false
Highchesters Hill	fort	0	false
Leadhills	remains of lead mining and smelting	0	false
Kielhope Law	 palisaded settlement	0	false
March Burn to Little Clyde	Roman road	0	false
Borthwick Mains	symbol stone	0	false
Hawick Moat Park	 motte	0	false
Pennymuir	Roman camps	0	false
Redshaw Burn	 Roman fortlet	0	false
Largiebaan	 shielings 750m SW of	0	false
Mote Knowe	dun	Monkwood	0	false
Katie Gray's Rocks	 settlement	0	false
Glenochar Burn	bastle house	post-medieval settlement & field system	0	false
Moat Knowe	fort	0	false
Hangingshaw Hill	 unenclosed settlement	 field system and cairn	0	false
Wanlockhead	remains of lead mining and smelting	0	false
Buchtrig	 settlement	 field system and barrow cemetery 800m SW of	0	false
Kaim Law	fort	0	false
Wanlockhead Beam Engine	0	false
Kilnsike Tower	0	false
Dere Street	Roman road & earthworks	Tow Ford to Blackhall Hill	0	false
Watermeetings	platform settlement 450m W of	0	false
Overton Tower	0	false
Orchard	cross socket	0	false
Iron Castle	earthwork	0	false
Plenderleith	 chapel and burial ground 700m N of	0	false
Rubh' a' Mharaiche	 dun 450m E of	0	false
Dowan's Hill	dun	Dunree	0	false
Glenmucklach	standing stone	Knockstapple	0	false
Woden Law	fort & Roman siegeworks	0	false
Kirkton Hill	fort	0	false
White Type-March Burn	Roman road	0	false
Whitcastle Hill and Todshaw Hill	 forts	 earthworks	 linear earthworks	0	false
Broad Tae	settlement 650m ESE of Corehead	0	false
The Bastard	dun ESE of	0	false
Bonchester Hill	earthworks	0	false
Stotfield	cultivation terraces	0	false
White Type	Roman signal station	0	false
Loddan Hill North	 palisaded settlement 800m NNE of summit	0	false
Howmoor Quarry	dun	0	false
Blackhall Hill	cairns	0	false
Heugh Law	 fort	0	false
White Hill	 settlement 700m SSE of Corehead	0	false
Mervinslaw Tower	0	false
Bonchester Hill	fort	0	false
Dunan Breac	dun 450m SE of Culinlongart	0	false
Stony Law	 fort	0	false
Plenderleith	 scooped settlement 300m SSW of	0	false
Wintercleugh	bastle house 1000m S of Tomont Hill	0	false
Carrifran	 farmstead 310m SW of	0	false
Dunan	fort NW of Corr Bhan	0	false
Loddan	 palisaded settlement 350m NW of summit	0	false
Hindhope Hill	fort	0	false
Balchriston Crossing	dun 320m E of	0	false
Dere Street	Roman road	Blackhall Hill to Black Halls	0	false
Loddan	 fort	0	false
Ericstane	fort	0	false
Glenehervie	 fort 800m W of	0	false
Doune	dun 400m NNE of Ormsary	0	false
Saddle Yoke	 township 1100m and 1050m NE of	0	false
Frizles Linn	 settlement 850m ESE of Newton	0	false
Goshen Hill	 palisaded settlement	0	false
Auchengruith Craig	cross-shaped earthwork	0	false
Auldhousehill Wood	settlement 600m SSW of Ericstane	0	false
Lyonston	standing stone 250m ESE of	0	false
Culzean Coves	 caves	0	false
Woodfoot Bridge	enclosure 430m NE of Pagton Burn	0	false
Waterside	 miners' villages & mineral railways N of	0	false
Holehouse Linn-Auldhousehill Bridge	Roman road	0	false
Slack's Tower	0	false
Maybole Collegiate Church	0	false
Kennel Mount cairn	 Culzean Country Park	0	false
Balmavicar Burn	township 170m N of	0	false
Mid Hill	fort & settlement 700m NW of Adderstonshiels	0	false
Bodesbeck	 standing stone 1180m E of	0	false
Chester Knowe	earthworks 775m ENE of Allanwater Reservoir	0	false
Meadowshaw	earthwork	0	false
Brownhart Law	Roman signal station & Roman road	Dere Street	0	false
Cnoc Araich	 fort N of High Machriemore	0	false
Lord's Tree Cairn	520m NNE of The Hero's Grave Cairn	0	false
Potburn	 house platforms 1425m NW of	0	false
Thomaston Castle	0	false
Shaw Craigs	fort	0	false
Northbank Tower	0	false
Macharioch	motte 800m W of	0	false
Southdean Law	fort & settlement	0	false
St Coivin's Chapel & burial ground 270m W of Macharioch	0	false
Blasthill	long cairn 640m NE of	0	false
Macharioch	chambered cairn	0	false
Crichton Peel & Sanquhar Castle	0	false
Smithwood	 bastle house 900m SW of Daerside	0	false
Southdean Church	0	false
Denholm Hill	forts 600m NE of Stobs Castle	0	false
Dykeraw Tower	Southdean	0	false
Wattie's Spindles	 pele house and associated buildings	0	false
Roundstonefoot House	 burnt mound 565m NNE of	0	false
Chapel Knowe	 farmstead 100m WSW of	0	false
Birny Knowe	earthwork	0	false
Kemps Castle	fort 320m SW of Euchan Bridge	0	false
Laight Castle	0	false
Steel Knowe	 medieval and later settlements and field systems	0	false
Ryehill	motte	0	false
Barns Burn	fort 680m NW of Newton Hill	0	false
Waterside	 Dalmellington Ironworks	0	false
Crossraguel Abbey	0	false
Waterside Bing	 iron slag bing	 Dalmellington Ironworks	0	false
Martinlee Plantation	 enclosure 140m N of	0	false
Newton Hill	fort	0	false
Martinlee Plantation	 homestead NW of Martinlee Sike	0	false
White Knowe	settlement 180m W of Newton Hill	0	false
Martinlee Sike	 enclosure bank	 field system	 cairns & old road	0	false
Martinlee Plantation	 homestead SE of Martinlee Sike	0	false
Brunerican	standing stone 225m SW of	0	false
Teindside Lodge	cairn 50m N of	0	false
Cnoc Eibhleach	dun 185m ENE of Pennysearach	0	false
Blaebeck	 burnt mound 240m N of	0	false
Bain's Hill	standing stone 300m W of Maidens Police Station	0	false
Keil Cave	 95m ESE of Seapoint	0	false
St Columba's Church	 rock-cut footprints & related remains	 Southend	0	false
Wolfcleughhead	 enclosures	 Craik Forest	0	false
Martinlee Sike	 farmstead	 field system and assart bank.	0	false
Dunaverty Castle	0	false
Change House	enclosure 320m WSW of	0	false
Dodburn Hill	earthworks & homestead	0	false
North House Cottages	cairn 200m SW of	0	false
Kildoon	fort	0	false
Dykeheads	homestead moat	0	false
Gray Hill	earthwork	0	false
Turnberry Castle	0	false
Crom Rig	farmstead 640m SW of Change House	0	false
Selcoth	scooped homestead 150m SW of	0	false
Coatshill Quarry to Holehouse Linn	 Roman Road.	0	false
Berryfell Farm	earthwork and linear earthwork 400m SSE of	0	false
Pleaknowe	fort & homestead 430m NW of	0	false
Blacklaw Tower	 associated buildings and enclosures	0	false
The Catrail	linear earthwork	350m long	N of Doecleugh Hill	0	false
Crom Rig	earthwork	0	false
Black Hill	settlement	0	false
Lairhope Cottage	deserted settlement 300m WNW of	0	false
Tamshiel Rig	 fort	 settlement and field system	0	false
Blakebillend	fort	0	false
Penchrise Pen	 fort 635m SW of Penchrise Farm Cottage	0	false
Burgh Hill	stone circle	0	false
Blakebillend	cairn 335m E of Williams Rig	0	false
Burgh Hill	fort and settlement	0	false
Craik's Craig	 scooped settlement 755m ESE of	0	false
Borgadel Water	dun 365m W of mouth of	0	false
Penchrise Pen	earthwork 420m E of	0	false
Hollowshean Camp	fort	0	false
Bogton Loch airfield	 175m SSE of Buchan's Bridge	 Dalmellington	0	false
Sron Uamha	 hut circle 280m NE of Sron Uamha cave	0	false
Sron Uamha	 fort 170m NNW of Sron Uamha cave	0	false
Alton	 moated site 530m ESE of	0	false
Dod	earthwork 300m NW of	0	false
Pen Sike	earthwork 300m SW of Penchrise Pen	0	false
The Catrail	linear earthwork	650m long	on SE slope of White Hill	0	false
Dalmellington	motte	0	false
Auldton Mote	motte	0	false
White Hill	fort	0	false
Frenchland	 farmstead and cultivation remains 695m NE of	0	false
Wheel Causeway	section 640m long on S slope of Wardmoor Hill	0	false
Kirkbride Kirk	Kirkbride	0	false
Dod	earthworks on right bank of Allan Water 670m WSW of	0	false
Dalnean Hill	 farmstead and field system	0	false
Westshiels	spur earthwork 1550m SW of	0	false
Frenchland Tower	 tower house	0	false
Craik Cross Hill-Borthwick Water	 Roman road	0	false
Pyat Knowe	enclosure 150m N of	0	false
Dod	enclosure on Gray Coat	530m SW of	0	false
Dod	earthworks on Gray Coat 540m SSW of	0	false
Camp Cottage	 fort and settlement 50m S of	0	false
Gray Coat	settlement 540m NE of Priesthaugh	0	false
Hunterheck Cottages	 scooped settlements 95m NNE of	0	false
Durisdeer	 Roman fortlet between Dash Cleuch and Kirk Burn	0	false
Coats Hill	 Roman Signal Station 215m W of Moffat Golf Club clubhouse	0	false
Gray Coat	pele-house 370m SE of	0	false
The Catrail	linear earthwork	SE slope of Singley Brae to Barry Sike	0	false
St Ninian's Chapel	Sanda	cruciform stone	0	false
St Ninian's Chapel	Sanda	0	false
St Ninian	cross slab	Sanda	Kintyre	0	false
Priesthaugh	earthwork 130m SSE of	0	false
Craiglynne	 two scooped settlements 660m and 750m SSE of	0	false
Over Cassock	 fort and enclosures 40m SSW of	0	false
Coats Hill	 motte 480m NE of St Margaret's	0	false
Garpol Water	 Motte-and-Bailey 650m SW of Rosetta	0	false
Garpol Water Moated Homestead	 500m SW of Rosseta	0	false
Tinlee	standing stone 718m SSE of Peelbraehope	0	false
Benoaks	 stone row 150m N of	0	false
Castlehill	earthwork 400m S of	0	false
Munteoch	 settlement and field systems	0	false
Cairn Sike	earthwork 1220m NE of Hawkhass House	0	false
Auchen Castle	0	false
Mid Raeburn to Craik Cross Hill	 Roman road & watch tower	0	false
John's Wood	two burial mounds	0	false
The Lady Chapel	640m NE of Kilkerran	0	false
Dowhill Mount	dun and earthwork	0	false
Hawkhass Linn	earthwork 520m NE of Hawkhass House	0	false
The Catrail	linear earthwork	W of Leap Burn to 100m E of Langside Burn	0	false
Craigbeck Hope	 burnt mound 1100m SW of	0	false
Davington	settlement and field system 400m W of to 1150m WNW of	0	false
Drummochreen	house	0	false
The Catrail	linear earthwork	Robert's Linn Bridge to Leap Burn	0	false
Beattock Hill	 settlement 700m W of Hillside Cottages	0	false
Easter Earshaig	 settlement 100m NW of	0	false
Beattock Hill	 fort and unenclosed settlement 935m W of Braeside	0	false
Dalquharran Castle (Old Castle)	0	false
Stanshielrig	homestead	enclosures	field systems & clearance cairns	0	false
Kinnelhead Tower	 fortified farmstead & cross incised stones	0	false
Craighead Hill	dun 380m WNW of	0	false
Druidhill Burn	motte	0	false
Ballaggan	motte	0	false
Kinnelhead Cottage	 building 285m SSW of	0	false
Milton	Roman fort	fortlet & camps	0	false
The King's Cairn	chambered cairn and cairn to W of Water of Deugh	0	false
Knockdon	 enclosure 700m NE of	0	false
Kinnelhead Cottage	 cairn 540m S of	0	false
Rough Castle Hill	 earthworks 525m W of Garwald	0	false
Moodlaw	settlement 600m S of	0	false
Mid Raeburn	enclosure 200m NNE of	0	false
Lochanhead	 cairn 530m WNW of	0	false
Knockinculloch	enclosures on E slope of	600m NW of Glenalla	0	false
Eyre Burn	 settlement 1km NNW of Stidriggs	0	false
Knock Hill	fort 1200m WSW of Kirkpatrick-Juxta Church	0	false
Cairnhill	palisaded enclosure and timber house 220m NNE of	0	false
Mote Knowe	motte	Kilkerran	0	false
Wheel Village	deserted settlement 1400m NE of Wormscleugh	0	false
Poldean	 standing stone 110m SSW of	0	false
Old Johnstone	settlement and farmstead 350m WNW of	0	false
Long Knowe	 settlement 905m SW of Monkenshaw	0	false
Fauld Burn	 enclosure and building 875m W of Stidriggs	0	false
Gallow Hill	settlement and ring-ditch 320m N of Girvan Mains	0	false
Lamb Knowe	 bank barrow and Roman camp 480m NNW of Raeburnfoot	0	false
Stidriggs	 fort and settlement 400m ESE of	0	false
Old Dailly Church	0	false
Catharine's Hill	 settlement 620m N of Nether Murthat	0	false
Morton Castle	castle	Morton Loch	0	false
Saugh Hill	barrow 28m NNE of summit of	0	false
Girvan Mains	 Roman camps	 linear cropmark and enclosure	0	false
Raeburnfoot	 Roman fort 200m SW of	0	false
Maxwellston Hill	fort	0	false
Stidriggs	 cairn 750m SSW of	0	false
Drumlanrig	 Roman fort and annexe 400m SE of Drumlanrig Castle	0	false
Cairnpark	circular enclosure 150m E of	0	false
Stiddrig Cairn	 long cairn and cairn	0	false
Laverhay Cottage	 enclosure 480m NNE of	0	false
Camregan Castle	0	false
Shiel Rig	settlement 650m N of Clerkhillgrain	0	false
Eweslees	 watch tower 1980m NW of	0	false
Clerkhill	settlements 800m NNW of	0	false
Houdston Hill	enclosure 300m SSW of Drumrannie Bridge	0	false
Clerkhill	homestead	unenclosed settlements & field system 400m N of	0	false
Tibbers Castle	0	false
Tom's Knowe	 bank barrow 25m to 350m S of Holm	0	false
Tibbers Castle	enclosure 300m SW of	0	false
Plewlands	 scooped settlement and farmstead 485m SW of	0	false
Parks	 scooped settlement and house platforms 770m NNW of	0	false
Carronbridge	Roman fortlet & enclosures	0	false
Park Hill	 fort	0	false
Morton Mill	circular enclosures 500m SE of	0	false
Nine Stones	 stone circle	 Ninestone Rig	0	false
Mote Hill	barrow 300m NNW of Coalpots Bridge	0	false
Eskdalemuir Manse	cairn 230m W of	0	false
Lochwood Castle	 The Mount	 Motte and Tower House Complex	0	false
Dumgree Church and burial ground	0	false
Eweslees	 settlements 105m and 265m NW of Fiddleton Bankend	0	false
Loupin' Stanes	 stone circle	0	false
Louisa Mine	 antimony mine and workings	 Glenshanna Burn	0	false
Donald's Isle	 Loch Doon	 settlement 750m SSW of Lamdoughty Farm	0	false
Wamphray	motte and bailey 100m NNE of Wamphray House	0	false
Fauld Brae-Craik Knowes	 Roman road	0	false
Watcarrick	earthwork 140m S of Bankhead	0	false
Girdlestanes	 stone circle	0	false
Hermitage Castle	 castle	 chapel	 enclosures	 deer trap	 park boundary and farmstead	0	false
Dow Hill	fort	0	false
Home Plantation	 square barrow cemetery 350m SSW of Nithbank	0	false
Steelman's Craig	enclosure 400m S of Watcarrick	0	false
Riccarton Tower	0	false
Shalloch Hill	palisaded enclosure 350m S of Shallochpark	0	false
Boreland Tower	0	false
Bessie's Hill	 settlement 150m NE of summit	0	false
Nith Bridge	cross 180m W of	0	false
Bessie's Hill	 fort 250m E of summit	0	false
Ogle Linn	 earthwork	0	false
Grennan Hill	 fort 250m S of	0	false
Poldivan Bridge	 cairn 730m ENE of	0	false
Loch Doon Castle	0	false
Castlehill	settlement 200m NNW of	0	false
Raehills	 scooped settlement 650m NE of	0	false
Holmhill	enclosure 500m S of	0	false
Unthank	settlement 300m NE of	0	false
Templand Mains	Roman signal station 770m NNW of	0	false
Loch Doon Castle	 original site & remains of	 570m NE of Craigmalloch	0	false
Unthank	church & burial ground 100m E of	0	false
Craigengillan	cairn	0	false
Bencallen Hill	chambered cairn	0	false
Holm of Daltallochan	stone circle & standing stone	0	false
Holm of Daltallochan	cross slab	0	false
Carthur Hill	fort	Boreland	0	false
Tynron Doon	fort	0	false
Peat Hill	 fort and scooped settlement	0	false
Woodhead lead mines and smelter	Carsphairn	0	false
Glenkeil Hill	settlement & field system 100m SW of Under Stennieswater	0	false
Rangecastle Hill	 fort	0	false
Meikledale	 settlement 800m NNW of	0	false
Elbeckhill	 fort and farmstead 345m ESE of	0	false
Mosspeeble	farmstead 350m W of	0	false
Over Rig	 enclosure 750m SSW of Whiteyett	0	false
Stennieswaterfoot	settlement 625m NNE of	0	false
Mosspeeble	enclosure 300m SE of	0	false
Barrack Hill	 scooped settlement	0	false
Whiteyett	 earthworks 575m SSE to 935m S and 650m S to 1060m S of	0	false
Deil's Jingle North	 linear earthwork	0	false
Dinvin	motte	0	false
Rigfoot	settlement	0	false
Todshawhill	 settlement 1085m WSW of	0	false
Kirkland	enclosure 300m WNW of	0	false
Haw Birren	enclosure	Westside	0	false
Effgill	settlement and field system 600m E of	0	false
Bankburnfoot	 enclosure 1350m WNW of	0	false
Castle O'er	 fort and linear earthworks	0	false
Bankburnfoot	 settlement 375m NW of	0	false
Fenton Heights	 scooped settlement	0	false
Capenoch Loch	long cairn	0	false
Castle Hill	 fort	0	false
Tanner's Linn	 earthwork	0	false
Cairn Avel	cairn 800m S of Carsphairn	0	false
Stennieswaterfoot	 homestead and enclosure 335m SW of	0	false
Crooks	 scooped settlement 290m NNE of	0	false
Millhill	 settlement	 enclosure and road 500m ENE of	0	false
Tanlawhill	farmstead and field system 1250m NW of	0	false
Upper Fenton	 burnt mounds 1605m and 1740m ESE of	0	false
The Knowe	 settlement 300m S of Castle O'er Farm	0	false
Dalmakethar Burn	fort	0	false
Gillesbie Cottages	 moated site 160m NNE of	0	false
Bankburnfoot	 settlement 1550m WSW of	0	false
Stroanfreggan Craig	fort	Smittens Bridge	0	false
Shielburn	settlement 350m NW of	0	false
Gillesbie Tower	0	false
Davie's Kirk	fort 40m W of	0	false
Shaw	rectangular enclosure 800m NNW of	on bank of Coates Burn	0	false
Brieryshaw Hill	fort and settlement	0	false
Georgefield	settlement 230m NNE of	0	false
Broom Hill	fort 1400m NW of Shaw	0	false
Gawin Moor	cairns and field system	Auchencairn	0	false
Lyneholm	settlement 500m WSW and homestead 250m SW of	0	false
Tanlawhill	 settlement 480m WNW of	0	false
Stroanfreggan Bridge	cairn	0	false
Maggiemauts Knowe	fort 150m NE of Courancehilly	0	false
Deil's Jingle South	 linear earthwork	0	false
Bogle Walls	 fort	0	false
Garage Cottage	 scooped settlements 390m SE of	0	false
The Knock	settlement 300m WSW of Burrancehill Cottages	0	false
Auchencairn	 cairn 500m NNE of	0	false
Broomhillbank Hill	 fort	0	false
Tanlawhill	settlement 250m S of	0	false
Tanlawhill	farmstead and cultivation remains 950m ESE of	0	false
Braidenoch Hill	cross slabs	0	false
Tanlawhill Cottages	 farmstead 865 m E of	0	false
Broomhillbank	 fort 910m ENE of	0	false
Wallace's House	fort 1100m NW of Burrance Bridge	0	false
Glendivan	settlement 200m SE of	0	false
Kirkholm Hill	 enclosure 500m W of Dinwoodie Lodge Cottage	0	false
Sorbie	settlement 650m NW of	0	false
Tanlawhill	settlement 1150m SE of	0	false
Glendivan	settlement 550m SE of	0	false
Mid Knock	unenclosed settlement 600m SW of	0	false
Mid Knock	enclosure 350m SSW of	0	false
Dinwoodie Mains	 cremation burials 500m WSW of	0	false
Sorbie	cultivation terraces 450m NW of	0	false
Camp Hill	 fort	 175m WSW of Bailliehill	0	false
Kirkland	church	0	false
Rowantree tollhouse and inn	 230m S of Laigh Rowantree Bridge	0	false
Witchshaw Rig	 unenclosed settlement 1290m NE of Heithatpark	0	false
Arkleton	 farmstead 1700m SE of	0	false
Nithside	motte & bailey 450m ESE of	0	false
Dinwoodie	 settlement 425m E of	0	false
Black Esk Bridge	farmstead and cultivation remains 680m S of	0	false
Lower Ingleston	motte and bailey 400m ENE of	0	false
Liddel Castle	Newcastleton	0	false
Loch Hill	 fort 745m NNE of Hoghill	0	false
Hoghill	settlements 250m ENE & 500m NNE of	0	false
Hangingshaw Farm	 Roman camp and prehistoric enclosures 800m WNW of	0	false
Maxwelton	motte	0	false
Carterton	fort	0	false
Carleton	motte	Little Carleton	0	false
Carleton Mains	enclosure 280m SE of	0	false
Hutton Mote	 motte	0	false
Boyken Burn	 township 695m W of Westerhall	0	false
Calkin	settlements and cultivation terraces 300m N of	0	false
Barndennoch	ring ditches 350m N of	0	false
Whitespots Cottages	enclosure 120m NE of	0	false
Lochbrow	 palisaded enclosures 270m SW of	0	false
Calkin	settlement 300m E of	0	false
2 Dinwoodie Green Cottages	 settlement 530m ENE of	0	false
Calkin	farmstead 500m WSW of	0	false
Archwood Hill	 fort	0	false
Henwell	settlement 100m E of	0	false
Calkin	settlement	 farmstead and linear earthworks 500m SSE of	0	false
Little Hill	 fort	0	false
Little Hartfell	 stone circle 1010m NNW of Whitcastles Cottage	0	false
Cowburn	 burnt mounds 1027m SE of	0	false
Dundeugh Castle	0	false
Potholm	palisaded settlement 850m ENE of	0	false
Cars Wood	fort	0	false
Old Hopsrigg	farmstead 700m SW of	0	false
Craig	 two forts 650m SSW of	0	false
Polmaddy	medieval and post-medieval settlement	0	false
Barntalloch Castle	 motte and bailey	 Staplegordon	0	false
Firtree Hill	fort	0	false
White Cairn	long cairn	Fleuchlarg	0	false
Milnholm	settlement 200m WSW of	0	false
Terrona	 scooped settlement 150m SE of	0	false
Shaw's Moor	cairnfield and ring-cairns SE of Hospital Wood	0	false
Lochrinnie Mote	motte 250m WNW of Craigmuie Lodge	0	false
Mullach	fort	0	false
Shaw's Moor	cairnfield and ring-cairn S of Hospital Wood	0	false
Milnholm Cottage	settlement and farmstead	0	false
Suie tollhouse	 670m SW of Kirriereoch Farm	0	false
Craigmuie Moor	Watch Knowe	fort	0	false
Kirk Hill	enclosure	0	false
Newland Hill	fort 1100m ENE of Capelfoot	0	false
Ettleton Cemetery	 tombstones	0	false
Newland Hill	 settlement 1560m E of Capelfoot	0	false
Long Knowe	long cairn	0	false
Lag Tower	0	false
Milnholm Cottage	farmstead 800m SSW of	0	false
Orchard Mote	earthwork	0	false
Kirkhill Castle	0	false
Gotterbie Moor	homestead moat	0	false
Moat	enclosure 300m NW of	0	false
The Belt	fort	High Townhead	0	false
Moatland	motte	0	false
King's Cairn	 chambered cairn 450m NE of Kirriemore	0	false
Murder Loch	Roman fortlet 120m NNW of Ivy Cottage	0	false
Knockdolian Castle	0	false
Craigneil Castle	0	false
Pearsby Hill	 enclosures and settlement 1250m E of Craighousesteads	0	false
Craighousesteads	fort	0	false
Duniewick Camp	dun	Knockdolian	0	false
Hencastle Rig	fort 140m NW of Old Craighouse	0	false
Becks	settlement 800m N of	0	false
Mid Hill	 settlement 1480m SSE of Cairnknowe	0	false
Langholm Castle	0	false
Bankhead	Roman fort	Dalswinton	0	false
Sundaywell	 fort 300m N of	0	false
Pyatshaws Rig	 settlement 965m NE of Meikle Whitriggs	0	false
Ballmalloch	chambered cairn	0	false
Gulf Sike	 scooped settlement 525m SE of Arresgill	0	false
Rough Island	crannog	0	false
Bankfoot	three enclosures	0	false
Calfield	 scooped settlement and farmstead 440m N of	0	false
Carby Hill	settlement	0	false
Dalswinton Mains	ring ditch and pit alignments	0	false
Brockloch	farmstead and field system 1000m WNW of Fraserford	0	false
Springfieldhill	 fort	0	false
Corrie Church	 church and graveyard	0	false
Ellisland	Roman camps	0	false
Applegarth House	 motte 65m S of	0	false
Gibb's Hill	 unenclosed settlement	palisaded settlements & houses	0	false
Kirtlehead	 unenclosed settlement 1850m N of	0	false
Dalswinton Old House	0	false
Bankfoot	Roman camps & forts	Dalswinton	0	false
Callisterhall	cairn 2550m NNE of	0	false
Earlston Castle	0	false
Wauchope Castle	 castle and manse 235m SSW of Springhill	0	false
Greencleuch Cottage	 settlement 1550m NNW of	0	false
Whisgills	 long cairn and standing stones 2230m W of	0	false
Sheuchan's Cairn	 chambered cairn	 Highlandman's Rig	0	false
Gallaberry Hill	 fort	0	false
Cleuchfoot	farmstead 1500m NE of	0	false
Old Kirkcudbright	church & graveyard	Kirk Holm	0	false
Newhall Hill	enclosures	0	false
Woody Castle	 fort	 Lochbank	 Lochmaben	0	false
Kilroy	enclosures E and NE of	0	false
Kirtlehead	 ring ditch house 1150m N of	0	false
Barrs Hill	fort	0	false
White Cairn	 cairn	 Corriedow Bridge	0	false
Doe's Hill	 settlement 915m N of Kirtlehead	0	false
Torwood	 enclosure 270m SW of	0	false
The Hass	 settlement 550m E of	 Quhytewoollen Hill	0	false
West Gallaberry	Roman camp & native promontory settlement	0	false
Seven Brethren	 stone circle	 Whiteholme Rig	0	false
Dryfesdalegate	 fort 75m SSE of	0	false
Ardstinchar Castle	0	false
Callisterhall	cairn 1100m NE of	0	false
Broomholmshiels	farmstead 1000m E of	0	false
Castle Hill	 motte-and-bailey castle	0	false
Callisterhall	farmstead 400m NNE of	0	false
Ladyward	 Roman fort 210m ENE of	0	false
Torwood Roman camp	 310m NNE of Lochside	0	false
Bloch Farm	enclosure 600 m N of	0	false
Raggiewhate	 enclosure 210m ESE of	0	false
Broomholm	farmstead 400m E of	0	false
Carzield	Roman fort	0	false
Garleffin	standing stones and mesolithic settlement	0	false
Fairholm	 fort 430m NNE of	0	false
Old Irvine	settlement 600m NNW of	0	false
Broomholm	 Roman fort	0	false
St John's Town of Dalry	 motte	0	false
Minsca	 settlement 295m WNW of	0	false
Lochmaben Peel and Castle	0	false
Birrens Hill	 enclosure and farmstead 750m W of Carruthers	0	false
Cairn Kinna	 two cairns 960m ESE of Corrafeckloch	0	false
Greenhillhead	fort	0	false
Holywood	cursus	linear earthwork	pit alignment & enclosures 975m SE of	0	false
Corrafeckloch	hut circle and field system 1150m SE of	0	false
Burnside of Baltersan	ring ditch	pits and Roman camp 700m S of	0	false
Cairnderry	 chambered cairn	0	false
Balig	enclosure	0	false
Balig	earthwork 530m WSW of	0	false
Holywood	 cursus 1250m SSE of	0	false
Malls Castle	 settlement 320m W of Mallscastle	0	false
Hall Hill	fort	0	false
Twelve Apostles	stone circle	0	false
Balmaclellan Motte	0	false
Gilnockie Roman Camp	 300m SW of New Woodhead	0	false
Dalarran Holm	standing stone	0	false
White Cairn	cairn 910m NNE of Bargrennan Cottage	0	false
Hallmuir	 settlement 510m WSW of	0	false
Burnswark or Birrenswark Hill	fort & Roman camps	0	false
Hallmuir	 settlement 630m SW of	0	false
Hallmuir	 settlement 490m S of	0	false
White Cairn	 chambered cairn 630m W of Glentrool School	0	false
Torthorwald Castle	0	false
Gilnockie Castle	 earthwork NE of Gilnockie Bridge	0	false
Lincluden College	 motte and precinct	0	false
McNaugton	fort	0	false
Douglashall Pendicle	 cairn 415m W of	0	false
Auchenhay	settlement 1000m S of	0	false
Nutholm Hill	 fort 400m ENE of Nutholmhill	0	false
Rockhall Mote	 motte-and-bailey castle	0	false
Nutholmhill	 settlement 160m E of	0	false
Middle Bridge of Cree	cairn 110m WNW of	0	false
Kenmure Castle	0	false
Range Castle	 fort	0	false
Hound Hill	 cairn	0	false
Dumfries Old Bridge	0	false
Moss Castle	 fort	0	false
Minnoch	Old Bridge of	0	false
Scalewood	 enclosure 370m W of	0	false
St Mungo's Church	 church and graveyard	0	false
Park House	cairn 730m SSE of	0	false
Kirkconnel old church and graveyard	 520m WNW of Springkell	0	false
Cairn Kenny	 chambered cairn	0	false
Curriestanes	cursus E of	0	false
Loch Maberry Castle	crannog	0	false
Birrens to Broadlee	Roman forts & camps & henge	0	false
Johnstonehall	Roman camps SE of	0	false
Markdhu	hut circle 1370m N of	0	false
Markdhu	cairn 1450m NNW of	0	false
Maurs Cairn	enclosure 1100m NNW of	0	false
Chalkyhill Wood	 settlement 320m SW of Cairnhill	0	false
Miltonise	burnt mound 1430m NNE of	0	false
Markdhu	hut circles and field system 1250m NNE of	0	false
Castledykes Park	 motte and bailey	 medieval castle and associated earthworks	0	false
Little Dalton Church	0	false
Markdhu	burnt mound 1090m NNE of	0	false
Blarbuie	stone setting 330m NE of	0	false
Timpanheck Cottage	 cursus 340m WNW of	0	false
Fairy Knowe	mound	0	false
Broadlee Cottages	 Roman fortlet	0	false
Loch Ochiltree	crannogs	0	false
Blacket House Tower	0	false
Markdhu	hut circle 1020m NE of	0	false
Maurs Cairn	hut circle and field clearance cairns 1000m WNW of	0	false
Finnart's Hill	enclosure	0	false
Markdhu	hut circle 730m NE of	0	false
Woodslee	burial mound 250m SW of	0	false
Miltonise	cairns 670m NNE of	0	false
Blarbuie	cairn 300m SW of	0	false
Dalton	 standing stone 25m WSW of Post Office	0	false
Miltonise	hut circle and cairns 800m NE of	0	false
Dalton	 old parish church	0	false
Thistle cottage	 fort 130m E of	0	false
East Hill Farmhouse	stone circle	0	false
Deil's Dike	linear earthwork	Hill of Ochiltree	0	false
Markdhu	hut circles and field system 100m NE of	0	false
Buckie Bank Cottage	 fort 95m SW of	0	false
Little Merkland	fort	0	false
Markdhu	cairn 450m ENE of	0	false
Scots' Dike	 boundary earthwork	 Scotsdike Plantation	0	false
Moat Hill	fort	Margley	0	false
Marklach	field clearance cairns 850m NNE of	0	false
Caspin	fort 690m NNW of West Balscalloch	0	false
Marklach	hut circles and field system 1900m WNW of	0	false
Dalvaird	 cairn 320m NNE of	0	false
Marklach	cairn 470m N of	0	false
Bonshaw Tile Works	 NW of Bonshawside	 Kirtlebridge	0	false
Dunskirloch	fort	0	false
Hoddom Church	 church	 burial ground and monastery	0	false
Marklach	hut circle and field clearance cairns 270m N of	0	false
Finnarts Bridge	cairn 620m SE of	0	false
Glenwhilly	hut circle and field clearance cairns 1500m NW of	0	false
Glenwhilly	hut circles and field system 1300m NW of	0	false
Cordorcan	 cairn 750m NE of	0	false
Marklach	 burnt mound 300m W of	0	false
Glenwhilly	burnt mound 1120m NW of	0	false
Southgate	 settlement 350m N of	0	false
Wells of the Rees	wells 500m NNE of Killgallioch	0	false
Glenwhilly	burnt mound 1190m NW of	0	false
Repentance Tower	0	false
Glenkitten	clearance cairns 250m NNW of	0	false
Glenwhilly	hut circle and enclosure 1590m NW of	0	false
Finnarts Bridge	burnt mound 630m SSE of	0	false
Picts Knowe	fort	0	false
Merkland Cross	 Woodhouse	0	false
Glenkitten	hut circle 800m E of	0	false
Glenkitten	farmstead	0	false
Stab Hill	 hut circle 1570m NE of Dalnigap	0	false
Long Tom	standing stone	Mildown	0	false
Dirniemow	burnt mound 900m NNE of	0	false
Claywarnies	 cairn	0	false
Robgill Tower	 fort 90m NW of	0	false
Laggangarn	 standing stones	0	false
Knockglass Rees	 hut circles & field system 1750m ENE of Dalnigap	0	false
Green Island	fort	Milton Loch	0	false
The Thieves	 standing stones	 Blair Hill	0	false
Knockglass Rees	 hut circle 1870m ENE of Dalnigap	0	false
Dirniemow	burnt mound 970m NE of	0	false
Woodhouse Tower	 tower house	0	false
Corsewall Castle	0	false
Napper's Cottage	chambered cairn	0	false
Glenwhilly	 burnt mound 1260m W of	0	false
Glenwhilly	 hut circle 1400m W of	0	false
Meikle Cairn	cairn	Upper Minnydow	0	false
St Bryde's Kirk	 church 95m W of Brydekirk Mains	0	false
Braehill	 enclosed settlement 450m SW of	0	false
Robgill Mains	 cairn 320m E of	0	false
Blackyett	 cairn 225m E of	0	false
Drumfern	cairn and remains of stone circle	0	false
Taxing Stone	standing stone 180m NNW of Little Laight	0	false
Milligansbush	 palisaded enclosure 250m SW of	0	false
Boreland Mote	motte	Boreland Glen	0	false
Brockloch	cairn	Cairn Hill	0	false
Dirniemow	cairn 420m SW of	0	false
Glenroan (or Glengappock) Mote	fort	0	false
Dirniemow	cairn 700m SW of	0	false
Old Hall	 480m ENE of Meikle Laight	0	false
Pultadie	cairn 470m NW of	0	false
Dirniemow	cairn 930m SW of	0	false
Pultadie	farmstead 100m N of	0	false
North Cairn	cairn 370m WSW of	0	false
Pultadie	farmstead 760m ENE of	0	false
Dirniemow	hut circle 1350m SW of	0	false
Pultadie	hut circle 1280m E of	0	false
Dirniemow	cairn 1050m SW of	0	false
Quarter Farm	farmstead 1600m NNW of	0	false
Kirkland Mote	motte	0	false
Awies	 hut circle and shielings 670m NW of	0	false
Craigbirnoch	hut circle and clearance cairns 1200m NE of	0	false
Altibrair	 hut circle and field system 1160m NE of Dalhabboch	0	false
Camp Hill	 enclosure 800m SE of Crochmore	0	false
Awies	 hut circle 420m WNW of	0	false
Dunnerum	 burnt mounds 910m NE of Dalhabboch	0	false
Little Duchrae	fort	0	false
Craigbirnoch	cairn 1170m NE of	0	false
Craigbirnoch	cairn 1050m NE of	0	false
Quarter Farm	farmstead 1130m NNE of	0	false
Pultadie	cairn 640m SSW of Glenwhilly	0	false
Quarter Farm	burnt mound 1130m N of	0	false
Craigbirnoch	 hut circle 1100m WNW of	0	false
Quarter Farm	burnt mound 1050m NNW of	0	false
Kilfeddar	 hut circle 1120m NNE of	0	false
Whinnyrig	 enclosed settlement	 droveway and field system 130m ENE of	0	false
Quarter Farm	burnt mound 1090m NNE of	0	false
Broats	 enclosure 250m N of	0	false
Quarter Farm	cairn 1340m NE of	0	false
Quarter Farm	farmstead 1070m NNE of	0	false
Calvertsholm Cottages	 cairn 320m NNW of	0	false
Diddles Hill	 hut circle & field system 900m WNW of Dalhabboch	0	false
Craigbirnoch	cairns 710m NE of	0	false
Awies	 hut circle and cairn 480m WSW of	0	false
Quarter Farm	burnt mound 1280m NE of	0	false
Craigbirnoch	burnt mound 640m NW of	0	false
Altaggart	 hut circle 870m NNE of Pularyan	0	false
Garlies Castle	0	false
Quarter Farm	clearance cairns 1200m NE of	0	false
Auld Kirk of Lochroan	fort	0	false
Calvertsholm Cottages	 cairn 315m WNW of	0	false
Craigbirnoch	enclosure 220m NW of	0	false
Trowdale	fort	0	false
Quarter Farm	enclosure 1380m NE of	0	false
Calvertsholm	 settlement 110m N of	0	false
Boreland	chambered cairn	0	false
Kilfeddar	 burnt mound 860m NE of	0	false
Craigbirnoch	burnt mound 490m WNW of	0	false
Diddles Hill	 cairn 800m WNW of Dalhabboch	0	false
Craigbirnoch	burnt mound 900m W of	0	false
Quarter Farm	hut circle 760m NW of	0	false
Craigbirnoch	clearance cairns 600m E of	0	false
Isle Tower	 400m NNE of Bankend	0	false
Doon Hill	Mote of Doon	Doon of Urr	0	false
The Bracken	 enclosed settlement and droveway 370m WSW of	0	false
Drumwhirn	cairn N of Boreland	0	false
Craigbirnoch	cairn 710m E of	0	false
Diddles Hill	 hut circles & enclosures 800m W of Dalhabboch	0	false
Craigbirnoch	burnt mound 470m WSW of	0	false
Dounan	fort	Dally	0	false
Fairy Knowes	 hut circle 1400m ENE of High Croach	0	false
Blacketlees Cottages	 enclosure 75m SSW of	0	false
Awies	 hut circle 700m SSW of	0	false
Wood Cairn	 cairn	 Eldrig Fell	0	false
Craigbirnoch	hut circles and field system 650m WSW of	0	false
High Croach	 settlement 750m NE of	0	false
Kirkcolm cross-slab	 Ervie-Kirkcolm Parish Church churchyard	0	false
Kilfeddar	 burnt mound 640m NE of	0	false
Quarter Farm	farmstead 570m NW of	0	false
Quarter Farm	clearance cairns 770m ENE of	0	false
Quarter Farm	burnt mound 920m ENE of	0	false
Quarter Farm	hut circle 420m NE of	0	false
Quarter Farm	burnt mound 530m NE of	0	false
Quarter Farm	field system 1050m ENE of	0	false
Kilfeddar	 cairn 320m ENE of	0	false
Pularyan	burnt mound 350m NW of	0	false
Quarter Farm	 burnt mound and clearance cairns 1340m ENE of	0	false
Craigbirnoch	burnt mound 550m SW of	0	false
Pularyan	cairns 370m WNW of	0	false
Drumacissock	 hut circle 990m SSE of Awies	0	false
Quarter Farm	burnt mound 230m ENE of	0	false
Quarter Farm	hut circle 220m WNW of	0	false
Pularyan	hut circle 850m W of	0	false
Drumcoltran Castle (Tower)	0	false
High Croach	 hut circle 650m E of	0	false
Pularyan	farm buildings and kiln 200m SE of	0	false
Craigbirnoch	burnt mound 900m SW of	0	false
Craigbirnoch	farmstead 770m SSE of	0	false
Craigbirnoch	cairn 1090m SW of	0	false
Pularyan	farmstead 180m SSW of	0	false
Pularyan	cairns 950m WSW of	0	false
High Croach	 fermtoun 250m ESE of	0	false
Pularyan	shielings 680m SW of	0	false
Craigbirnoch	burnt mound 1080m SW of	0	false
Cairnerzean	cairns 700m NW of	0	false
Cairn Connell Hill	 enclosed settlements 480m NNW of Clendrie	0	false
Castle Ban	motte	0	false
Branthat Plantation	 enclosed settlement 320m SE of Gill	0	false
Cairnerzean	hut circle 770m WNW of	0	false
Erncrogo Loch	 fish ponds 400m S of Erncrogo	0	false
Woodhead	enclosure 200m NE of	0	false
Cairnerzean	farmstead 350m NW of	0	false
Knockiebae	hut circle and clearance cairns 1720m N of	0	false
Drummuckloch Hill	 cairn & standing stone 1140m NNE of Drummuckloch	0	false
Quarter Farm	field system 950m SE of	0	false
Cairnerzean	hut circle 2600m W of	0	false
Drummuckloch Hill	 hut circle 1070m NNE of Drummuckloch	0	false
Cairnerzean	cairns 300m E of	0	false
Pularyan	 hut circle 900m SSW of	0	false
Cairn na Gath	 long cairn	 Balmurrie Fell	0	false
Mains of Airies	farmstead 900m WSW of	0	false
Drummuckloch Hill	 hut circles & field system 900m NE of Drummuckloch	0	false
Barlure	 burnt mound 810m NW of	0	false
Little Larg	sheiling 1400m NW of	0	false
Quarter Farm	farmstead 1050m SSE of	0	false
Barlure	 burnt mound & enclosure 470m NNE of	0	false
Cairnerzean	farmstead 750m WSW of	0	false
Cairnerzean	shieling 500m SW of	0	false
Cairnerzean	shielings 550m SW of	0	false
Cairnerzean	farmstead 350m S of	0	false
Cairnerzean	farmstead 1650m WSW of	0	false
Knockiebae	farmstead 1600m NE of	0	false
Little Larg	burnt mound 1250m NW of	0	false
Cairnsmore of Fleet	 cairn	0	false
Cairnerzean	farmstead	cairns and field systems 2100m WSW of	0	false
Cairnerzean	farmstead 650m SW of	0	false
Cairnerzean	cairn 500m SSE of	0	false
Beoch Burn	 hut circle & enclosure 500m NNW of Braid Fell	0	false
Cairnerzean	shielings and enclosures 950m SW of	0	false
Barlure	cairn	0	false
Craigiegower	farmstead and clearance cairns	0	false
Cairnerzean	hut circle 1450m SW of	0	false
Knockiebae	hut circles 1000m NNE of	0	false
Cairnerzean	hut circle 830m SW of	0	false
Knockiebae	clearance cairns 1100m NNE of	0	false
Cairnerzean	hut circle 1900m WSW of	0	false
Little Larg	farmstead 1300m NW of	0	false
High Milton	 dun 230m NE of	0	false
Ward Law	 fort and Roman camp	0	false
White Cairn	 cairn 1600m NNE of Beoch	0	false
Knockiebae	burnt mound 880m NNE of	0	false
Mote of Annan	 motte-and-bailey castle	 70m SSW of Moat House	0	false
Little Larg	burnt mound 800m NW of	0	false
Knockiebae	hut circle and field system 800m NNW of	0	false
Cairnerzean	cairns 800m SSW of	0	false
Little Larg	burnt mound 1400m WNW of	0	false
Knockiebae	hut circle 700m N of	0	false
Little Larg	sheilings and burnt mound 900m NW of	0	false
Redkirkmill	 enclosure 50m WSW of	0	false
Little Larg	field system 1100m WNW of	0	false
Knockiebae	burnt mounds 810m NNE of	0	false
Cairnerzean	hut circle and cairns 1350m SSW of	0	false
Annan old graveyard	 recumbent grave marker 45m ENE of town hall	0	false
Ward Law	 prehistoric enclosure and roundhouse 360m WSW of	0	false
Little Larg	enclosures	cairns and banks 1350m WNW of	0	false
Minnigaff	 Old Church	0	false
Knockiebae Lead Mines	0	false
Beoch	 cairn 1300m NNE of	0	false
Lingdowey Cairns	cairns S of Cairnezean	0	false
Cairnerzean	mound 1300m SW of	0	false
Minnigaff	 motte S of Monigaff Parish Church	0	false
Mains of Cairnbrock	fort 1250m NW of	0	false
Hurkledale	 enclosure 400m SW of	0	false
Cairnerzean	hut circle 1200m SSW of	0	false
Balmaghie	 enclosures 100m NW of Balmaghie Church	0	false
Little Larg	farmstead and dykes 900m W of	0	false
Little Larg	hut circle 1300m W of	0	false
Little Larg	cairns 1600m W of	0	false
Knockiebae	farmstead 850m NE of	0	false
Knockiebae	burnt mound 470m NNE of	0	false
Woodfield	 enclosure 295m NE of	0	false
Knockiebae	clearance cairns 350m N of	0	false
Little Larg	cairn and field system 1100m W of	0	false
Cairnerzean	cairns 1330m SSW of	0	false
Skaith Mote	motte 700m SSW of Challoch	0	false
Cairnerzean Fell	cairns	0	false
Sweetheart Abbey	 abbey	 precinct and walls	0	false
Barnshangan	clearance cairns 850m N of	0	false
Craig Hill	fort	Laurieston	0	false
Cairnerzearn	cairn 1700m SW of	0	false
Lochmaben Stone	standing stone & stone	0	false
Little Larg	hut circle and cairns 1300m W of	0	false
Burnbrae	 enclosure 270m W of	0	false
Cairnerzean	cairn 1850m SW of	0	false
Gleningle	 enclosure 80m NE of	0	false
Crofts Mote	fort	0	false
Cairnerzean Fell	farmstead and enclosure 1450m SW of	0	false
Little Larg	cairns 2150m W of	0	false
Little Larg	cairns 1950m W of	0	false
Little Larg	 hut circles and field system 1000m WSW of	0	false
Braid	 farmstead and cultivation remains 1200m ENE of Beoch	0	false
Barnshangan	enclosures 370m N of	0	false
Beoch	 palisaded enclosures 800m WNW of	0	false
Knockiebae	hut circle and enclosure 600m SE of	0	false
Barnshangan	field system 700m ENE of	0	false
Creebridge	 cairn 400m E of	0	false
Hayknowes	 settlement 180m NW of	0	false
Westhills	 altar stone 35m N of	0	false
Beoch	 palisaded enclosure 470m WNW of	0	false
Caerlaverock Castle and Old Castle	castles	courtyards and harbour	0	false
Annan Hill Roman camp	0	false
High Auchneel	fort 890m WSW of	0	false
Barnshangan	cairn 600m W of	0	false
Barnshangan	cairn 450m W of	0	false
Beoch	 farmstead 340m E of	0	false
Little Larg	cairn 2700m WSW of	0	false
Redcastle	 standing stone 275m ESE of Graham's Wood	 Haugh of Urr	0	false
Machars Hill	motte	0	false
Little Larg	 cairn 890m S of	0	false
Ingleston Mote	motte	0	false
High Auchneel	forts 1000m SW of	0	false
Little Larg	hut circle and cairns 2050m SW by W of	0	false
Auld Wife's Grave	 chambered cairn	 Cairnscarrow	0	false
Hardcroft	burnt mound 750m ENE of	0	false
Hardcroft	burnt mound 850m ENE of	0	false
New Luce Station	two cairns 690m WNW of	0	false
Hardcroft	farmstead 650m ENE of	0	false
Little Larg	burnt mound 1800m SW of	0	false
Hardcroft	hut circles 700m E of	0	false
Mote of Urr	motte	0	false
Glenlochar	Roman fort	 annexe	 road	 camps & barrows 50m E of Montford	0	false
Tor of Craigoch	fort 1200m NW of Leswalt	0	false
Little Tongue	 hut circle 1390m N of	0	false
Little Larg	farmstead 1950m SW of	Auchie	0	false
Hardcroft	farmstead 350m ESE of	0	false
Hardcroft	hut circle and field system 220m SE of	0	false
Little Larg	burnt mound 2150m SW of	0	false
Hardcroft	hut circle 1000m ESE of	0	false
Tarkirra	fort	0	false
Balker Moor	 cairn 1470m NNE of Balker	0	false
Caves of Kilhern	chambered cairn 450m SE of Dranigower Lodge	0	false
Little Larg	burnt mound 2250m SW of	0	false
Balneil	field system 1000m NE of	0	false
Little Larg	burnt mound 1850m SSW of	0	false
Balneil	cairn 560m NE of	0	false
Balneil	cairn 1200m ENE of	0	false
Balneil	farmstead 650m NE of	0	false
Hardcroft	cairn 950m SE of	0	false
Teroy Fort	 broch	 Craigcaffie	0	false
Little Tongue	 hut circle 1050m NW of	0	false
Dalminnoch	 enclosure 250m SSE of	0	false
Hardcroft	burnt mound 950m SSE of	0	false
Mid Dinduff	 fort 100m ESE of	0	false
Hardcroft	cairn 1400m ESE of	0	false
Craigcaffie	 palisaded enclosure 280m ESE of	0	false
Mains of Larg	burnt mound 1250m SW of	0	false
Balneil	burnt mound 650m E of	0	false
Craigcaffie	 palisaded enclosure 410m WSW of	0	false
Milton of Larg	 hut circle 1100m WNW of	0	false
Leswalt	 Old Parish Church	0	false
Milton of Larg	cairn N of	0	false
Little Tongue	 hut circles 660m NNW of	0	false
Auchmantle	farmstead 1000m N of	0	false
Hardcroft	burnt mound 1100m SSE of	0	false
Meikle Tongue	 hut circle 930m N of	0	false
Little Tongue	 hut circle 410m NNW of	0	false
Castle Earthworks	enclosure 500m SSW of Mains of Greenlaw	0	false
Loan Hill	 cairn 500m NW of Little Tongue	0	false
Glenhead of Aldouran	 fort 270m SE of	0	false
Hardcroft	burnt mound 1500m SE of	0	false
Hardcroft	burnt mounds 1600m SE of	0	false
Cruise	cairn 1250m NE of	0	false
Cruise	burnt mound 1100m NE of	0	false
Cruise	cairn 1140m NE of	0	false
Creachmore Cottage	 barrow 110m NNW of	0	false
Innermessan Mote	motte	0	false
Galdenoch Castle	Meikle	0	false
Old Lochnaw Castle	 Isle of Lochnaw	0	false
Ernespie	 remains of stone circle 200m E of Erne Hill	 Castle Douglas	0	false
Cruise	burnt mound 1730m ENE of	0	false
Edgarton Mote	fort 690m SW of Camelon Bridge	0	false
Cruise	burnt mound 1740m ENE of	0	false
Pinwherrie Farm	 burnt mound 760m NNE of	 beside Coburn Burn	0	false
Bennan of Garvilland	fort	0	false
Edingham Castle	0	false
Milton of Larg	 corn mill 810m SSW of	0	false
Cairn MacNeilie	cairn	0	false
Bargatton Farm	cairn 610m S of	0	false
Standing Stones of Glenterrow	0	false
Littlepark Cairn	cairn	0	false
Cruise	burnt mounds 950m ESE of	0	false
Mid Gleniron	hut circle and cairns 1100m N of	0	false
High Airyolland	 hut circle 400m NW of	0	false
Edingham Munitions Factory	0	false
High Airyolland	 burnt mounds 430m WNW of	0	false
Threave Castle	0	false
Mid Gleniron	rectangular buildings and cairns 1350m NE of	0	false
Cruise Back Fell	fort	0	false
Cruise	farmstead 900m SE of	0	false
Mid Gleniron	farmstead and field system 1050m NNW of	0	false
Meikle Wood Hill	 fort	 Kelton Mains	0	false
Mid Gleniron	croft 900m NNE of	0	false
Galdenoch	farmstead 1050m E of	0	false
Mid Gleniron	burnt mound 730m N of	0	false
High Airyolland	 burnt mound 490m WSW of	0	false
Cairn Macneilie	 cairn 360m ESE of Inch Parks	0	false
Galdenoch	farmstead 950m ENE of	0	false
Mid Gleniron	hut circle 650m N of	0	false
Galdenoch	farmstead 625m E of	0	false
Mid Gleniron	hut circles and field systems 850m NE of	0	false
High Baltersan	cairn	0	false
Buittle Castle	0	false
Galdenoch	farmstead 600m ESE of	0	false
Fort Point	fort and salt-pans	Salt Pans Bay	Galdenoch	0	false
Carscreugh Croft	cairn 800m SSE of	0	false
Meikle Larbrax	hut circle 1000m NNE of	0	false
High Airyolland	 hut circle 680m S of	0	false
Loch Mannoch	cairn & stone circle N end of	0	false
Galdenoch	farmstead 500m SE of	0	false
Slewcairn	 hut circle on W bank of Mid Burn	0	false
Slewcairn	 two cairns	0	false
Black Loch	 crannog on Heron Isle	0	false
Meikle Larbrax	farmstead 1040m NW of	0	false
Meikle Larbrax	hut circles 460m NW of	0	false
Castle Kennedy	0	false
Mid Gleniron	 chambered cairns and cairns	0	false
Sheuchan	 enclosure 400m S of	0	false
Chlenry Hill	 hut circle 780m ESE of Chlenry	0	false
Chlenry	 ring-ditches 380m SW of	0	false
Ballach-a-heathry	 cairn	0	false
Pibble	lead mines	0	false
Castle Kennedy House	 fort 630m ESE of	0	false
Chlenry Cottages	 enclosure 420m S of	0	false
Cults Loch	 crannog 770m ESE of Castle Kennedy House	0	false
Craig	 cairn 700m SW of	0	false
Chlenry	 ring-ditches & enclosures 750m S of	0	false
Glenwhan Moor	hut circle 840m N of Old Hall Farm	0	false
Glenwhan Moor	 hut circles 1000m NE of Old Hall Farm	0	false
Cascreugh Castle	0	false
Meikle Labrax	fort	0	false
Buittle Old Kirk	0	false
Mid Ochtrelure	 enclosure 250m NNW of	0	false
Gallahill	cairn 300m NNW of	0	false
Tonnachrae	 enclosure 500m NNW of	0	false
Tonnachrae	 palisaded enclosure 450m N of	0	false
Tonnachrae	 palisaded enclosure 260m NNW of	0	false
Castle Hill	fort	Castlegower	0	false
Auchenskeock Castle	0	false
Pennyliggit	 palisaded enclosure 350m S of	0	false
Soulseat Abbey	 abbey & burial-ground 700m NNW of Mahaar	0	false
Tonnachrae	 enclosure 70m SE of	0	false
Glenluce Abbey	0	false
Boreland Mote	motte	0	false
Kirminnoch	enclosure and ring ditches 250m NNW of	0	false
Pulcree Mote	motte	0	false
Mahaar	 barrow 320m N of	0	false
Cairntosh Hill	cairn	0	false
Billy Diamond's Bridge	 stone circle 300m SSE of	 Glenquicken	0	false
Mahaar	 ring-ditches 400m NE of	0	false
White Cairn	 cairn 90m S of Boreland	0	false
Boreland	 stone circle 250m S of	0	false
Cairnhouse	 two cairns	0	false
Round Dounan	fort	Dunragit House	0	false
Knock and Maize	standing stone 190m ESE of	0	false
Drumflower Bridge	enclosures and pit alignments E of	0	false
Mark	 enclosed settlement E of	0	false
Knock and Maize	farmstead 250m SE of	0	false
McCulloch's Castle	fort	Arbigland	0	false
Moyle Hill	 enclosure	0	false
Kirkcormack	motte	Mayfield	0	false
Little Lochans	 ring-ditch house 410m SSE of	0	false
Trostrie Mote	motte	0	false
Cambret Moor	 cup and ring marked rock 590m SE of Cambret Hill	0	false
Gatehouse-of-Fleet	Roman fortlet	0	false
Little Lochans	 barrow & ring-ditches 520m SW of	0	false
Dunragit	enclosures and pit alignments S of	0	false
Killantringan	dun 740m WNW of	0	false
Cauldside Burn	 cairns and stone circle SE of Cambret Hill	0	false
Barsolus	 palisaded enclosures 490m N of	0	false
Castle of Park	 castle	 Glenluce	0	false
Kirminnoch	 ring-ditches and associated remains 870m S of	0	false
Mark	 settlement 820m SE of	0	false
Barsolus Cottage	 enclosure 150m NNE of	0	false
Southwick Church	0	false
Droughdool Mote	motte	0	false
Mark Cottage	 palisaded enclosure 1010m SE of	0	false
Mark Cottage	 unenclosed settlement 1150m SE of	0	false
Torhousekie	 fort	0	false
Culgrange	 enclosures 340m SE of	0	false
Glenluce Roman camp	 380m W of Corsehead	0	false
Barsolus	 fort 240m ESE of	0	false
Kildrochat House	 fort 250m NE of	0	false
Torhouse Stone Circle	0	false
Bagbie	 cairn & stone setting 1200m NNE of	0	false
Cairn Pat	 or Piot	 fort	0	false
Anwoth Old Church	cross slab & Gordon Tomb	0	false
Standing Stone of Bagbie	 standing stone	0	false
Park	stone circle	0	false
East Galdenoch	 enclosures 450m NE of	0	false
Trusty's Hill	fort & symbol stone	0	false
Claughreid	 stone circle 600m NW of	0	false
West Galdenoch	 ring-ditch & enclosure 250m WSW of	0	false
Knock Fell	fort	0	false
White Cairn	cairn & Hole Stone 400m N of Crows	0	false
East Galdenoch	 enclosures 100m SE of	0	false
Moat Park	motte	Cally	0	false
East Galdenoch	 fort 450m SSW of	0	false
Cardoness Castle	0	false
Garthland Mains	 enclosure 240m SSW of	0	false
Garthland Mains	 enclosures 190m S of	0	false
Orchardton Tower	0	false
Boreland or Green Tower Mote	motte	0	false
Mains of Torhouse	 laird's house and farmstead	0	false
Wigtown Castle	0	false
Garthland Cottages	 palisaded enclosure 120m NNW of	0	false
White Loch	 roundhouse 310m SE of	0	false
Fort Cottage	fort 1360m WSW of	0	false
Palace Yard	homestead moat	Enrick	0	false
Portpatrick	old parish kirk	0	false
Carsluith Castle	0	false
Cairn Holy	 chambered cairn 35m S of Cairnholy	0	false
Mote of Mark	fort	Rockcliffe	0	false
Dounan Moor	depopulated village	Corsemalzie Forest	0	false
Arden	fort 320m SW of	0	false
Nethertown Cottages	 fort 450m ESE of	0	false
Cairn Holy	 chambered cairn 190m SSW of Cairnholy	0	false
High Auchenlarie	 cairn 800m NW of	0	false
Dungarry	fort	0	false
Culquhasen	cairn 320m W of	0	false
High Auchenlarie	stone circle & cup & ring marked rock 380m N of	0	false
Dunskey Castle	0	false
Girthon Old Parish Church	0	false
Carse Mote	fort	0	false
Stair Haven	 broch 300m S of	0	false
Mains of Caldons	 enclosure 260m S of	0	false
Hass	fort	700m NNW of Glenhead	0	false
Kirkdale House	two cross slabs	0	false
Kirkdale House	six cup & ring marked stones	0	false
Cumstoun Castle	0	false
Conchieton	 cairn NE of	0	false
Conchieton	 The Doon	 fort	 Doon Hill	0	false
Mye Plantation	pitfall	0	false
Crailloch Mote	homestead 180m NE of Crailloch	0	false
Standing Stones of Newton	 burial chamber	0	false
Brockcleugh Cottage	cup and ring marked rocks 600m NNE of	0	false
High Gillespie	long cairn 475m SSE of	0	false
Castlehill Point	fort	West Barcloy	0	false
Kirkclaugh	 cross-slab 20m E of	0	false
Laigh Sinniness	fort	0	false
Auchenmalg	 standing stone 200m SSE of Longforth	0	false
Kirkclaugh Mote	motte	0	false
Castlehill	fort	Compstonend	0	false
Boreland Mote	earthwork 500m NNE of	0	false
Camphill Cottage	fort or homestead moat	Whinnieliggate	0	false
Port O`Spittal	motte 1120m W of	0	false
Boreland Mote	motte	0	false
Craignarget	 cairn 800m ENE of	0	false
Collin Mill Bridge	fort	0	false
Doon Hill	fort	0	false
Doon of May	fort	0	false
Meikle Sypland	 fort	0	false
Maclellan's Castle	0	false
Garheugh	cairn 1050m NW of	0	false
Ring Hill	 fort	0	false
Cairn Buy	cairn 720m NW of Garheugh	0	false
Kirkcudbright Castle	0	false
Suie Hill	fort	0	false
Culshabbin	cairn	0	false
Kirkland	fort NNW of High Kirkland	0	false
Plunton Castle	Lennox Plunton	0	false
Kirklauchlane Farm	fort	0	false
Seaside	forts 590m SSW & 400m SW of	0	false
Balgreggan	motte	0	false
Heston Island	manor house	0	false
East Kirkcarswell	fort	0	false
Carlin Stone	450m NW of Loch Head	0	false
Ardwall Island	chapels & cemetery	0	false
West Kirkcarswell	fort	0	false
Barhobble	 Early Christian site (remains of)	 180m SSW of Elrig House	0	false
Barmagachan Mote	motte	0	false
Knockbrex Fort	 55m ENE of Doonwood	0	false
Castlecreavie	forts 270m ENE of	0	false
Rough Loch	crannog 450m ESE of	0	false
High Banks Farm	cup and ring marked rocks 350m SE of	0	false
Chapel Finian	 chapel	 enclosure and well	0	false
Doon Wood	fort	Nun Mill Bridge	0	false
West Kirkcarswell	motte	0	false
Float	hut circles and field system 1300m WSW of	0	false
Float	hut circle and enclosure 1050m WSW of	0	false
Kirkmabreck	 palisaded enclosure 600m NNW of	0	false
Roberton Moat	motte	Roberton Bridge	0	false
South Cairnweil	standing stone 180m ESE of	0	false
Kirkmadrine	 site of Kirkmadrine Church	0	false
Castle Haven	dun	Castle Haven Bay	0	false
Nether Hazelfield	fort	0	false
High Fort	fort	North Milton	0	false
Elrig	fort 230m W of	0	false
Two forts S.E. and S.S.E. of Chippermore	0	false
Elrig Farm	 cairn 340m SW of	0	false
North Milton	fort 235m NNE of	0	false
Garlieston	 Mulberry harbour remains 2070m ENE	 1035m E and 1860m S of	0	false
Grange	 cup and ring marked rocks	0	false
Dundrennan Abbey	0	false
Barn Heugh	fort	Kirkandrews	0	false
Little Float	fort 630m SW of	0	false
Eggerness	carved stones 750m SW of	0	false
Stonehouse	crannog 800m WSW of	0	false
Castle Muir	fort	Rascarrel Heugh	0	false
Clauchendolly	 cup and ring marked rocks 350m WSW of	0	false
Craigencroy	cairn 270m SSE of West Ringuinea	0	false
Milton	fort 180m NNW of	0	false
Doonhill	fort	0	false
Sorbie	Old Tower of	0	false
Doon Hill	 fort	 Balig	0	false
Float Bay	fort SE of	0	false
Druchtag Mote Hill	0	false
Blackhill	cup and ring marked rock 60m SE of	0	false
Muncraig Heugh	fort	0	false
Drummore Farm	stone circle	0	false
Dunrod	 homestead moat	 village & church site	0	false
Drummore Castle	fort	Castle Hill	0	false
Broughton Mains	cup & ring marked rocks	0	false
Ardwell Mote	motte 420m E of Ardwell House	0	false
Killaser Castle	0	false
Glennap	 fort	 Barcheskie	0	false
Riffer Park	enclosure 320m SSE of	0	false
Drumtroddan	 cup marked rocks	0	false
Doon Castle	broch	Ardwell	0	false
Borness Batteries	fort	0	false
Drumtroddan	three standing stones SE of High Park Plantation	0	false
White Loch	crannog	0	false
Big Balcraig	cup and ring marked rocks 650m WNW of and 600m NNW of	0	false
Craigraploch	 fort	 Abbey Burnfoot	0	false
Grennan Point	fort	Drumbreddan	0	false
Myrton Castle	tower	Monreith Park	0	false
Castle Wigg	 tower and mansion house 100m SE of Castlewigg	0	false
Cruggleton Castle	0	false
Duniehinnie	fort	0	false
The Wren's Egg	 two standing stones 18m ENE and two standing stones 406m SSE of	0	false
Fell of Barhullion	fort 550m S of	0	false
Clanghie Point	fort	0	false
Clanghie Point	fort 200m E of	0	false
Stellock	cup & ring marked rocks ENE of	Monreith	0	false
Killumpha	 standing stone 1140m NE of	0	false
Barsalloch Fort	0	false
Whithorn Priory	 monastic settlement and priory	0	false
Dinnans	two forts	0	false
Kirkmaiden	church & burial ground	0	false
Rispain Camp	0	false
Little Balsmith	standing stone	0	false
Muldaddie	fort 510m SW of	0	false
Back Bay	fort 580m S of Knock	Monreith	0	false
Cairnhead	fort	0	false
Low Curghie	standing stone 480m NNW of	0	false
Glasserton	cup & ring marked rocks	0	false
Laggan	fort	Carleton	0	false
Steinhead	fort 550m ESE of Isle Farm	0	false
Kirkmaiden	fort	0	false
Drummoral	fort	0	false
Barncorkrie	hut circles & field system 520m NNW of	0	false
St Ninian's Chapel	 Isle of Whithorn	0	false
Cairn More	Barncorkrie	cairn	0	false
Barncorkrie	farmstead 350m NNW of	0	false
Barncorkrie	farmstead 450m NE of	0	false
Isle Head	fort	0	false
St Ninian's Cave	0	false
High Drummore Mote	motte	0	false
Castle Feather	fort	Burrow Head	0	false
Burrow Head	forts W of	0	false
Crammog	fort	Slock Mill	0	false
Dunman	fort	Slock Mill	0	false
Eagle Cairn	cairn	Cardryne	0	false
Kirkmaiden Church	church & churchyard 500m N of Mull of Galloway Farm	0	false
Mull of Galloway Farm	fort 400m NE of	0	false
Cardryne	fort 800m SSW of	0	false
Mull Farm	St Medan's Chapel & cave 550m SE of	0	false
West Cairngaan	standing stone 860m SE of	0	false
Two forts on Carrickcamrie and Dunorroch	0	false
Mull Glen	fort	West Tarbet	0	false
Mull of Galloway	 fortifications N & S ends of Isthmus	0	false
Mull of Galloway Farm	 cairn 2300m SE of	0	false
